"","aniyr_species","species","population","study_areas_id","aniyr","animals_id","sex","time","total","clc0tcd0","clc1tcd1","clc0tcd1","clc1tcd0","tcd_open_abs","tcd_forest_abs","clc_open_abs","clc_forest_abs","clc0tcd0_prop","clc1tcd1_prop","clc0tcd1_prop","clc1tcd0_prop","tcd_open_prop","tcd_forest_prop","clc_open_prop","clc_forest_prop","yearx"
"9","1402_2010_roe","roe",2,2,"1402_2010",1402,"f","night",108,0,39,0,69,69,39,0,108,0,0.361111111111111,0,0.638888888888889,0.638888888888889,0.361111111111111,0,1,"2010"
"10","1402_2010_roe","roe",2,2,"1402_2010",1402,"f","day",103,0,100,0,3,3,100,0,103,0,0.970873786407767,0,0.029126213592233,0.029126213592233,0.970873786407767,0,1,"2010"
"11","14_2006_roe","roe",2,2,"14_2006",14,"f","night",167,0,51,0,116,116,51,0,167,0,0.305389221556886,0,0.694610778443114,0.694610778443114,0.305389221556886,0,1,"2006"
"12","14_2006_roe","roe",2,2,"14_2006",14,"f","day",129,0,106,0,23,23,106,0,129,0,0.821705426356589,0,0.178294573643411,0.178294573643411,0.821705426356589,0,1,"2006"
"13","14_2007_roe","roe",2,2,"14_2007",14,"f","night",178,0,54,0,124,124,54,0,178,0,0.303370786516854,0,0.696629213483146,0.696629213483146,0.303370786516854,0,1,"2007"
"14","14_2007_roe","roe",2,2,"14_2007",14,"f","day",179,0,152,0,27,27,152,0,179,0,0.849162011173184,0,0.150837988826816,0.150837988826816,0.849162011173184,0,1,"2007"
"15","14_2010_roe","roe",2,2,"14_2010",14,"f","night",117,0,45,0,72,72,45,0,117,0,0.384615384615385,0,0.615384615384615,0.615384615384615,0.384615384615385,0,1,"2010"
"16","14_2010_roe","roe",2,2,"14_2010",14,"f","day",108,1,88,0,19,20,88,1,107,0.00925925925925926,0.814814814814815,0,0.175925925925926,0.185185185185185,0.814814814814815,0.00925925925925926,0.990740740740741,"2010"
"17","1429_2010_roe","roe",2,2,"1429_2010",1429,"f","night",108,0,88,20,0,0,108,20,88,0,0.814814814814815,0.185185185185185,0,0,1,0.185185185185185,0.814814814814815,"2010"
"18","1429_2010_roe","roe",2,2,"1429_2010",1429,"f","day",107,0,100,7,0,0,107,7,100,0,0.934579439252336,0.0654205607476635,0,0,1,0.0654205607476635,0.934579439252336,"2010"
"19","1453_2010_roe","roe",15,15,"1453_2010",1453,"f","night",185,159,24,0,2,161,24,159,26,0.859459459459459,0.12972972972973,0,0.0108108108108108,0.87027027027027,0.12972972972973,0.859459459459459,0.140540540540541,"2010"
"20","1453_2010_roe","roe",15,15,"1453_2010",1453,"f","day",184,124,46,0,14,138,46,124,60,0.673913043478261,0.25,0,0.0760869565217391,0.75,0.25,0.673913043478261,0.326086956521739,"2010"
"21","1454_2010_roe","roe",15,15,"1454_2010",1454,"m","night",185,182,1,0,2,184,1,182,3,0.983783783783784,0.00540540540540541,0,0.0108108108108108,0.994594594594595,0.00540540540540541,0.983783783783784,0.0162162162162162,"2010"
"22","1454_2010_roe","roe",15,15,"1454_2010",1454,"m","day",184,164,7,0,13,177,7,164,20,0.891304347826087,0.0380434782608696,0,0.0706521739130435,0.96195652173913,0.0380434782608696,0.891304347826087,0.108695652173913,"2010"
"23","1455_2010_roe","roe",15,15,"1455_2010",1455,"f","night",180,36,122,0,22,58,122,36,144,0.2,0.677777777777778,0,0.122222222222222,0.322222222222222,0.677777777777778,0.2,0.8,"2010"
"24","1455_2010_roe","roe",15,15,"1455_2010",1455,"f","day",180,2,165,0,13,15,165,2,178,0.0111111111111111,0.916666666666667,0,0.0722222222222222,0.0833333333333333,0.916666666666667,0.0111111111111111,0.988888888888889,"2010"
"25","1457_2010_roe","roe",15,15,"1457_2010",1457,"f","night",183,181,0,1,1,182,1,182,1,0.989071038251366,0,0.00546448087431694,0.00546448087431694,0.994535519125683,0.00546448087431694,0.994535519125683,0.00546448087431694,"2010"
"26","1457_2010_roe","roe",15,15,"1457_2010",1457,"f","day",183,175,3,2,3,178,5,177,6,0.956284153005464,0.0163934426229508,0.0109289617486339,0.0163934426229508,0.972677595628415,0.0273224043715847,0.967213114754098,0.0327868852459016,"2010"
"61","1728_2006_roe","roe",8,8,"1728_2006",1728,"f","night",162,100,0,62,0,100,62,162,0,0.617283950617284,0,0.382716049382716,0,0.617283950617284,0.382716049382716,1,0,"2006"
"62","1728_2006_roe","roe",8,8,"1728_2006",1728,"f","day",141,64,1,76,0,64,77,140,1,0.453900709219858,0.00709219858156028,0.539007092198582,0,0.453900709219858,0.546099290780142,0.99290780141844,0.00709219858156028,"2006"
"63","1728_2011_roe","roe",8,8,"1728_2011",1728,"f","night",182,137,0,45,0,137,45,182,0,0.752747252747253,0,0.247252747252747,0,0.752747252747253,0.247252747252747,1,0,"2011"
"64","1728_2011_roe","roe",8,8,"1728_2011",1728,"f","day",168,68,0,100,0,68,100,168,0,0.404761904761905,0,0.595238095238095,0,0.404761904761905,0.595238095238095,1,0,"2011"
"143","1777_2008_roe","roe",8,8,"1777_2008",1777,"m","night",179,172,0,7,0,172,7,179,0,0.960893854748603,0,0.0391061452513966,0,0.960893854748603,0.0391061452513966,1,0,"2008"
"144","1777_2008_roe","roe",8,8,"1777_2008",1777,"m","day",169,143,0,26,0,143,26,169,0,0.846153846153846,0,0.153846153846154,0,0.846153846153846,0.153846153846154,1,0,"2008"
"145","1777_2011_roe","roe",8,8,"1777_2011",1777,"m","night",183,182,0,1,0,182,1,183,0,0.994535519125683,0,0.00546448087431694,0,0.994535519125683,0.00546448087431694,1,0,"2011"
"146","1777_2011_roe","roe",8,8,"1777_2011",1777,"m","day",170,116,44,5,5,121,49,121,49,0.682352941176471,0.258823529411765,0.0294117647058824,0.0294117647058824,0.711764705882353,0.288235294117647,0.711764705882353,0.288235294117647,"2011"
"183","1807_2009_roe","roe",8,8,"1807_2009",1807,"m","night",176,172,0,4,0,172,4,176,0,0.977272727272727,0,0.0227272727272727,0,0.977272727272727,0.0227272727272727,1,0,"2009"
"184","1807_2009_roe","roe",8,8,"1807_2009",1807,"m","day",165,147,2,16,0,147,18,163,2,0.890909090909091,0.0121212121212121,0.096969696969697,0,0.890909090909091,0.109090909090909,0.987878787878788,0.0121212121212121,"2009"
"185","1807_2011_roe","roe",8,8,"1807_2011",1807,"m","night",180,173,0,7,0,173,7,180,0,0.961111111111111,0,0.0388888888888889,0,0.961111111111111,0.0388888888888889,1,0,"2011"
"186","1807_2011_roe","roe",8,8,"1807_2011",1807,"m","day",161,127,0,34,0,127,34,161,0,0.788819875776398,0,0.211180124223602,0,0.788819875776398,0.211180124223602,1,0,"2011"
"197","1817_2009_roe","roe",8,8,"1817_2009",1817,"f","night",181,173,0,8,0,173,8,181,0,0.955801104972376,0,0.0441988950276243,0,0.955801104972376,0.0441988950276243,1,0,"2009"
"198","1817_2009_roe","roe",8,8,"1817_2009",1817,"f","day",149,108,0,41,0,108,41,149,0,0.724832214765101,0,0.275167785234899,0,0.724832214765101,0.275167785234899,1,0,"2009"
"199","1817_2011_roe","roe",8,8,"1817_2011",1817,"f","night",184,181,0,3,0,181,3,184,0,0.983695652173913,0,0.016304347826087,0,0.983695652173913,0.016304347826087,1,0,"2011"
"200","1817_2011_roe","roe",8,8,"1817_2011",1817,"f","day",164,116,0,48,0,116,48,164,0,0.707317073170732,0,0.292682926829268,0,0.707317073170732,0.292682926829268,1,0,"2011"
"211","1827_2011_roe","roe",8,8,"1827_2011",1827,"f","night",184,174,0,10,0,174,10,184,0,0.945652173913043,0,0.0543478260869565,0,0.945652173913043,0.0543478260869565,1,0,"2011"
"212","1827_2011_roe","roe",8,8,"1827_2011",1827,"f","day",180,128,2,50,0,128,52,178,2,0.711111111111111,0.0111111111111111,0.277777777777778,0,0.711111111111111,0.288888888888889,0.988888888888889,0.0111111111111111,"2011"
"225","1835_2011_roe","roe",8,8,"1835_2011",1835,"f","night",160,99,48,10,3,102,58,109,51,0.61875,0.3,0.0625,0.01875,0.6375,0.3625,0.68125,0.31875,"2011"
"226","1835_2011_roe","roe",8,8,"1835_2011",1835,"f","day",141,42,87,11,1,43,98,53,88,0.297872340425532,0.617021276595745,0.0780141843971631,0.00709219858156028,0.304964539007092,0.695035460992908,0.375886524822695,0.624113475177305,"2011"
"237","1857_2011_roe","roe",8,8,"1857_2011",1857,"f","night",182,177,0,5,0,177,5,182,0,0.972527472527473,0,0.0274725274725275,0,0.972527472527473,0.0274725274725275,1,0,"2011"
"238","1857_2011_roe","roe",8,8,"1857_2011",1857,"f","day",174,138,0,36,0,138,36,174,0,0.793103448275862,0,0.206896551724138,0,0.793103448275862,0.206896551724138,1,0,"2011"
"239","1859_2011_roe","roe",8,8,"1859_2011",1859,"m","night",172,143,0,29,0,143,29,172,0,0.831395348837209,0,0.168604651162791,0,0.831395348837209,0.168604651162791,1,0,"2011"
"240","1859_2011_roe","roe",8,8,"1859_2011",1859,"m","day",144,54,0,90,0,54,90,144,0,0.375,0,0.625,0,0.375,0.625,1,0,"2011"
"241","1860_2011_roe","roe",8,8,"1860_2011",1860,"m","night",171,161,0,10,0,161,10,171,0,0.941520467836257,0,0.0584795321637427,0,0.941520467836257,0.0584795321637427,1,0,"2011"
"242","1860_2011_roe","roe",8,8,"1860_2011",1860,"m","day",110,91,0,19,0,91,19,110,0,0.827272727272727,0,0.172727272727273,0,0.827272727272727,0.172727272727273,1,0,"2011"
"243","1861_2011_roe","roe",8,8,"1861_2011",1861,"m","night",172,165,0,7,0,165,7,172,0,0.959302325581395,0,0.0406976744186047,0,0.959302325581395,0.0406976744186047,1,0,"2011"
"244","1861_2011_roe","roe",8,8,"1861_2011",1861,"m","day",161,115,0,46,0,115,46,161,0,0.714285714285714,0,0.285714285714286,0,0.714285714285714,0.285714285714286,1,0,"2011"
"245","1865_2011_roe","roe",8,8,"1865_2011",1865,"m","night",181,177,0,4,0,177,4,181,0,0.977900552486188,0,0.0220994475138122,0,0.977900552486188,0.0220994475138122,1,0,"2011"
"246","1865_2011_roe","roe",8,8,"1865_2011",1865,"m","day",167,74,0,93,0,74,93,167,0,0.44311377245509,0,0.55688622754491,0,0.44311377245509,0.55688622754491,1,0,"2011"
"247","1866_2011_roe","roe",8,8,"1866_2011",1866,"f","night",184,181,1,2,0,181,3,183,1,0.983695652173913,0.00543478260869565,0.0108695652173913,0,0.983695652173913,0.016304347826087,0.994565217391304,0.00543478260869565,"2011"
"248","1866_2011_roe","roe",8,8,"1866_2011",1866,"f","day",183,144,1,37,1,145,38,181,2,0.786885245901639,0.00546448087431694,0.202185792349727,0.00546448087431694,0.792349726775956,0.207650273224044,0.989071038251366,0.0109289617486339,"2011"
"249","1867_2011_roe","roe",8,8,"1867_2011",1867,"m","night",180,140,3,35,2,142,38,175,5,0.777777777777778,0.0166666666666667,0.194444444444444,0.0111111111111111,0.788888888888889,0.211111111111111,0.972222222222222,0.0277777777777778,"2011"
"250","1867_2011_roe","roe",8,8,"1867_2011",1867,"m","day",177,62,10,101,4,66,111,163,14,0.350282485875706,0.0564971751412429,0.570621468926554,0.0225988700564972,0.372881355932203,0.627118644067797,0.92090395480226,0.0790960451977401,"2011"
"251","1869_2011_roe","roe",8,8,"1869_2011",1869,"m","night",183,169,8,6,0,169,14,175,8,0.923497267759563,0.0437158469945355,0.0327868852459016,0,0.923497267759563,0.0765027322404372,0.956284153005464,0.0437158469945355,"2011"
"252","1869_2011_roe","roe",8,8,"1869_2011",1869,"m","day",140,6,134,0,0,6,134,6,134,0.0428571428571429,0.957142857142857,0,0,0.0428571428571429,0.957142857142857,0.0428571428571429,0.957142857142857,"2011"
"253","1871_2011_roe","roe",8,8,"1871_2011",1871,"f","night",138,60,69,1,8,68,70,61,77,0.434782608695652,0.5,0.0072463768115942,0.0579710144927536,0.492753623188406,0.507246376811594,0.442028985507246,0.557971014492754,"2011"
"254","1871_2011_roe","roe",8,8,"1871_2011",1871,"f","day",116,19,88,6,3,22,94,25,91,0.163793103448276,0.758620689655172,0.0517241379310345,0.0258620689655172,0.189655172413793,0.810344827586207,0.21551724137931,0.78448275862069,"2011"
"255","1873_2011_roe","roe",8,8,"1873_2011",1873,"f","night",170,106,58,5,1,107,63,111,59,0.623529411764706,0.341176470588235,0.0294117647058824,0.00588235294117647,0.629411764705882,0.370588235294118,0.652941176470588,0.347058823529412,"2011"
"256","1873_2011_roe","roe",8,8,"1873_2011",1873,"f","day",161,20,130,11,0,20,141,31,130,0.124223602484472,0.807453416149068,0.0683229813664596,0,0.124223602484472,0.875776397515528,0.192546583850932,0.807453416149068,"2011"
"257","1874_2011_roe","roe",8,8,"1874_2011",1874,"f","night",173,140,27,5,1,141,32,145,28,0.809248554913295,0.15606936416185,0.0289017341040462,0.00578034682080925,0.815028901734104,0.184971098265896,0.838150289017341,0.161849710982659,"2011"
"258","1874_2011_roe","roe",8,8,"1874_2011",1874,"f","day",148,81,60,6,1,82,66,87,61,0.547297297297297,0.405405405405405,0.0405405405405405,0.00675675675675676,0.554054054054054,0.445945945945946,0.587837837837838,0.412162162162162,"2011"
"259","1875_2011_roe","roe",8,8,"1875_2011",1875,"f","night",182,153,10,14,5,158,24,167,15,0.840659340659341,0.0549450549450549,0.0769230769230769,0.0274725274725275,0.868131868131868,0.131868131868132,0.917582417582418,0.0824175824175824,"2011"
"260","1875_2011_roe","roe",8,8,"1875_2011",1875,"f","day",172,94,50,13,15,109,63,107,65,0.546511627906977,0.290697674418605,0.0755813953488372,0.0872093023255814,0.633720930232558,0.366279069767442,0.622093023255814,0.377906976744186,"2011"
"261","1876_2011_roe","roe",8,8,"1876_2011",1876,"f","night",183,172,0,11,0,172,11,183,0,0.939890710382514,0,0.0601092896174863,0,0.939890710382514,0.0601092896174863,1,0,"2011"
"262","1876_2011_roe","roe",8,8,"1876_2011",1876,"f","day",177,102,6,68,1,103,74,170,7,0.576271186440678,0.0338983050847458,0.384180790960452,0.00564971751412429,0.581920903954802,0.418079096045198,0.96045197740113,0.0395480225988701,"2011"
"263","1878_2011_roe","roe",8,8,"1878_2011",1878,"f","night",183,168,1,14,0,168,15,182,1,0.918032786885246,0.00546448087431694,0.0765027322404372,0,0.918032786885246,0.0819672131147541,0.994535519125683,0.00546448087431694,"2011"
"264","1878_2011_roe","roe",8,8,"1878_2011",1878,"f","day",183,130,3,50,0,130,53,180,3,0.710382513661202,0.0163934426229508,0.273224043715847,0,0.710382513661202,0.289617486338798,0.983606557377049,0.0163934426229508,"2011"
"265","1880_2011_roe","roe",8,8,"1880_2011",1880,"f","night",177,153,1,23,0,153,24,176,1,0.864406779661017,0.00564971751412429,0.129943502824859,0,0.864406779661017,0.135593220338983,0.994350282485876,0.00564971751412429,"2011"
"266","1880_2011_roe","roe",8,8,"1880_2011",1880,"f","day",135,48,3,83,1,49,86,131,4,0.355555555555556,0.0222222222222222,0.614814814814815,0.00740740740740741,0.362962962962963,0.637037037037037,0.97037037037037,0.0296296296296296,"2011"
"267","1881_2011_roe","roe",8,8,"1881_2011",1881,"f","night",180,177,0,3,0,177,3,180,0,0.983333333333333,0,0.0166666666666667,0,0.983333333333333,0.0166666666666667,1,0,"2011"
"268","1881_2011_roe","roe",8,8,"1881_2011",1881,"f","day",157,153,0,4,0,153,4,157,0,0.974522292993631,0,0.0254777070063694,0,0.974522292993631,0.0254777070063694,1,0,"2011"
"269","1882_2011_roe","roe",8,8,"1882_2011",1882,"f","night",175,140,20,0,15,155,20,140,35,0.8,0.114285714285714,0,0.0857142857142857,0.885714285714286,0.114285714285714,0.8,0.2,"2011"
"270","1882_2011_roe","roe",8,8,"1882_2011",1882,"f","day",152,101,32,2,17,118,34,103,49,0.664473684210526,0.210526315789474,0.0131578947368421,0.111842105263158,0.776315789473684,0.223684210526316,0.677631578947368,0.322368421052632,"2011"
"271","1882_2013_roe","roe",8,8,"1882_2013",1882,"f","night",178,127,20,2,29,156,22,129,49,0.713483146067416,0.112359550561798,0.0112359550561798,0.162921348314607,0.876404494382023,0.123595505617978,0.724719101123595,0.275280898876405,"2013"
"272","1882_2013_roe","roe",8,8,"1882_2013",1882,"f","day",147,92,40,4,11,103,44,96,51,0.625850340136054,0.272108843537415,0.0272108843537415,0.0748299319727891,0.700680272108844,0.299319727891156,0.653061224489796,0.346938775510204,"2013"
"273","1883_2011_roe","roe",8,8,"1883_2011",1883,"f","night",178,163,0,15,0,163,15,178,0,0.915730337078652,0,0.0842696629213483,0,0.915730337078652,0.0842696629213483,1,0,"2011"
"274","1883_2011_roe","roe",8,8,"1883_2011",1883,"f","day",165,98,0,67,0,98,67,165,0,0.593939393939394,0,0.406060606060606,0,0.593939393939394,0.406060606060606,1,0,"2011"
"323","1936_2011_roe","roe",8,8,"1936_2011",1936,"m","night",183,162,0,21,0,162,21,183,0,0.885245901639344,0,0.114754098360656,0,0.885245901639344,0.114754098360656,1,0,"2011"
"324","1936_2011_roe","roe",8,8,"1936_2011",1936,"m","day",177,66,0,111,0,66,111,177,0,0.372881355932203,0,0.627118644067797,0,0.372881355932203,0.627118644067797,1,0,"2011"
"325","1937_2010_roe","roe",8,8,"1937_2010",1937,"f","night",184,184,0,0,0,184,0,184,0,1,0,0,0,1,0,1,0,"2010"
"326","1937_2010_roe","roe",8,8,"1937_2010",1937,"f","day",183,171,0,12,0,171,12,183,0,0.934426229508197,0,0.0655737704918033,0,0.934426229508197,0.0655737704918033,1,0,"2010"
"327","1937_2011_roe","roe",8,8,"1937_2011",1937,"f","night",182,174,0,8,0,174,8,182,0,0.956043956043956,0,0.043956043956044,0,0.956043956043956,0.043956043956044,1,0,"2011"
"328","1937_2011_roe","roe",8,8,"1937_2011",1937,"f","day",182,159,0,23,0,159,23,182,0,0.873626373626374,0,0.126373626373626,0,0.873626373626374,0.126373626373626,1,0,"2011"
"329","1937_2012_roe","roe",8,8,"1937_2012",1937,"f","night",184,181,0,3,0,181,3,184,0,0.983695652173913,0,0.016304347826087,0,0.983695652173913,0.016304347826087,1,0,"2012"
"330","1937_2012_roe","roe",8,8,"1937_2012",1937,"f","day",167,158,0,9,0,158,9,167,0,0.946107784431138,0,0.0538922155688623,0,0.946107784431138,0.0538922155688623,1,0,"2012"
"337","1956_2010_roe","roe",2,2,"1956_2010",1956,"f","night",111,21,64,26,0,21,90,47,64,0.189189189189189,0.576576576576577,0.234234234234234,0,0.189189189189189,0.810810810810811,0.423423423423423,0.576576576576577,"2010"
"338","1956_2010_roe","roe",2,2,"1956_2010",1956,"f","day",104,13,67,22,2,15,89,35,69,0.125,0.644230769230769,0.211538461538462,0.0192307692307692,0.144230769230769,0.855769230769231,0.336538461538462,0.663461538461538,"2010"
"339","1958_2010_roe","roe",2,2,"1958_2010",1958,"f","night",113,0,109,0,4,4,109,0,113,0,0.964601769911504,0,0.0353982300884956,0.0353982300884956,0.964601769911504,0,1,"2010"
"340","1958_2010_roe","roe",2,2,"1958_2010",1958,"f","day",112,0,109,0,3,3,109,0,112,0,0.973214285714286,0,0.0267857142857143,0.0267857142857143,0.973214285714286,0,1,"2010"
"343","1962_2010_roe","roe",2,2,"1962_2010",1962,"m","night",119,41,50,26,2,43,76,67,52,0.34453781512605,0.420168067226891,0.218487394957983,0.0168067226890756,0.361344537815126,0.638655462184874,0.563025210084034,0.436974789915966,"2010"
"344","1962_2010_roe","roe",2,2,"1962_2010",1962,"m","day",115,54,41,16,4,58,57,70,45,0.469565217391304,0.356521739130435,0.139130434782609,0.0347826086956522,0.504347826086956,0.495652173913044,0.608695652173913,0.391304347826087,"2010"
"345","1964_2010_roe","roe",2,2,"1964_2010",1964,"m","night",114,27,76,1,10,37,77,28,86,0.236842105263158,0.666666666666667,0.0087719298245614,0.087719298245614,0.324561403508772,0.675438596491228,0.245614035087719,0.754385964912281,"2010"
"346","1964_2010_roe","roe",2,2,"1964_2010",1964,"m","day",108,27,73,4,4,31,77,31,77,0.25,0.675925925925926,0.037037037037037,0.037037037037037,0.287037037037037,0.712962962962963,0.287037037037037,0.712962962962963,"2010"
"351","1973_2010_roe","roe",2,2,"1973_2010",1973,"f","night",108,26,26,11,45,71,37,37,71,0.240740740740741,0.240740740740741,0.101851851851852,0.416666666666667,0.657407407407407,0.342592592592593,0.342592592592593,0.657407407407407,"2010"
"352","1973_2010_roe","roe",2,2,"1973_2010",1973,"f","day",104,1,91,7,5,6,98,8,96,0.00961538461538462,0.875,0.0673076923076923,0.0480769230769231,0.0576923076923077,0.942307692307692,0.0769230769230769,0.923076923076923,"2010"
"353","1973_2011_roe","roe",2,2,"1973_2011",1973,"f","night",108,29,24,10,45,74,34,39,69,0.268518518518519,0.222222222222222,0.0925925925925926,0.416666666666667,0.685185185185185,0.314814814814815,0.361111111111111,0.638888888888889,"2011"
"354","1973_2011_roe","roe",2,2,"1973_2011",1973,"f","day",110,2,82,11,15,17,93,13,97,0.0181818181818182,0.745454545454545,0.1,0.136363636363636,0.154545454545455,0.845454545454545,0.118181818181818,0.881818181818182,"2011"
"359","1982_2010_roe","roe",2,2,"1982_2010",1982,"m","night",115,0,108,0,7,7,108,0,115,0,0.939130434782609,0,0.0608695652173913,0.0608695652173913,0.939130434782609,0,1,"2010"
"360","1982_2010_roe","roe",2,2,"1982_2010",1982,"m","day",113,0,102,0,11,11,102,0,113,0,0.902654867256637,0,0.0973451327433628,0.0973451327433628,0.902654867256637,0,1,"2010"
"361","1985_2010_roe","roe",2,2,"1985_2010",1985,"m","night",121,5,54,0,62,67,54,5,116,0.0413223140495868,0.446280991735537,0,0.512396694214876,0.553719008264463,0.446280991735537,0.0413223140495868,0.958677685950413,"2010"
"362","1985_2010_roe","roe",2,2,"1985_2010",1985,"m","day",117,1,104,1,11,12,105,2,115,0.00854700854700855,0.888888888888889,0.00854700854700855,0.094017094017094,0.102564102564103,0.897435897435897,0.0170940170940171,0.982905982905983,"2010"
"367","1991_2010_roe","roe",2,2,"1991_2010",1991,"f","night",121,19,82,19,1,20,101,38,83,0.15702479338843,0.677685950413223,0.15702479338843,0.00826446280991736,0.165289256198347,0.834710743801653,0.31404958677686,0.685950413223141,"2010"
"368","1991_2010_roe","roe",2,2,"1991_2010",1991,"f","day",110,5,101,4,0,5,105,9,101,0.0454545454545455,0.918181818181818,0.0363636363636364,0,0.0454545454545455,0.954545454545455,0.0818181818181818,0.918181818181818,"2010"
"369","1993_2010_roe","roe",2,2,"1993_2010",1993,"f","night",102,13,63,22,4,17,85,35,67,0.127450980392157,0.617647058823529,0.215686274509804,0.0392156862745098,0.166666666666667,0.833333333333333,0.343137254901961,0.656862745098039,"2010"
"370","1993_2010_roe","roe",2,2,"1993_2010",1993,"f","day",99,5,87,6,1,6,93,11,88,0.0505050505050505,0.878787878787879,0.0606060606060606,0.0101010101010101,0.0606060606060606,0.939393939393939,0.111111111111111,0.888888888888889,"2010"
"371","1994_2010_roe","roe",2,2,"1994_2010",1994,"m","night",116,32,55,29,0,32,84,61,55,0.275862068965517,0.474137931034483,0.25,0,0.275862068965517,0.724137931034483,0.525862068965517,0.474137931034483,"2010"
"372","1994_2010_roe","roe",2,2,"1994_2010",1994,"m","day",111,11,69,31,0,11,100,42,69,0.0990990990990991,0.621621621621622,0.279279279279279,0,0.0990990990990991,0.900900900900901,0.378378378378378,0.621621621621622,"2010"
"373","1994_2011_roe","roe",2,2,"1994_2011",1994,"m","night",121,27,77,16,1,28,93,43,78,0.223140495867769,0.636363636363636,0.132231404958678,0.00826446280991736,0.231404958677686,0.768595041322314,0.355371900826446,0.644628099173554,"2011"
"374","1994_2011_roe","roe",2,2,"1994_2011",1994,"m","day",119,14,82,23,0,14,105,37,82,0.117647058823529,0.689075630252101,0.19327731092437,0,0.117647058823529,0.882352941176471,0.310924369747899,0.689075630252101,"2011"
"375","1996_2010_roe","roe",2,2,"1996_2010",1996,"f","night",116,58,16,13,29,87,29,71,45,0.5,0.137931034482759,0.112068965517241,0.25,0.75,0.25,0.612068965517241,0.387931034482759,"2010"
"376","1996_2010_roe","roe",2,2,"1996_2010",1996,"f","day",113,18,36,25,34,52,61,43,70,0.15929203539823,0.31858407079646,0.221238938053097,0.300884955752212,0.460176991150442,0.539823008849557,0.380530973451327,0.619469026548673,"2010"
"377","2000_2010_roe","roe",2,2,"2000_2010",2000,"f","night",121,99,18,4,0,99,22,103,18,0.818181818181818,0.148760330578512,0.0330578512396694,0,0.818181818181818,0.181818181818182,0.851239669421488,0.148760330578512,"2010"
"378","2000_2010_roe","roe",2,2,"2000_2010",2000,"f","day",119,30,79,8,2,32,87,38,81,0.252100840336134,0.663865546218487,0.0672268907563025,0.0168067226890756,0.26890756302521,0.73109243697479,0.319327731092437,0.680672268907563,"2010"
"381","2008_2010_roe","roe",2,2,"2008_2010",2008,"m","night",110,0,51,0,59,59,51,0,110,0,0.463636363636364,0,0.536363636363636,0.536363636363636,0.463636363636364,0,1,"2010"
"382","2008_2010_roe","roe",2,2,"2008_2010",2008,"m","day",114,0,108,0,6,6,108,0,114,0,0.947368421052632,0,0.0526315789473684,0.0526315789473684,0.947368421052632,0,1,"2010"
"383","2008_2011_roe","roe",2,2,"2008_2011",2008,"m","night",114,0,35,0,79,79,35,0,114,0,0.307017543859649,0,0.692982456140351,0.692982456140351,0.307017543859649,0,1,"2011"
"384","2008_2011_roe","roe",2,2,"2008_2011",2008,"m","day",109,0,81,0,28,28,81,0,109,0,0.743119266055046,0,0.256880733944954,0.256880733944954,0.743119266055046,0,1,"2011"
"385","2011_2010_roe","roe",2,2,"2011_2010",2011,"f","night",118,90,24,2,2,92,26,92,26,0.76271186440678,0.203389830508475,0.0169491525423729,0.0169491525423729,0.779661016949153,0.220338983050847,0.779661016949153,0.220338983050847,"2010"
"386","2011_2010_roe","roe",2,2,"2011_2010",2011,"f","day",116,12,100,3,1,13,103,15,101,0.103448275862069,0.862068965517241,0.0258620689655172,0.00862068965517241,0.112068965517241,0.887931034482759,0.129310344827586,0.870689655172414,"2010"
"387","2013_2010_roe","roe",2,2,"2013_2010",2013,"f","night",121,28,89,4,0,28,93,32,89,0.231404958677686,0.735537190082645,0.0330578512396694,0,0.231404958677686,0.768595041322314,0.264462809917355,0.735537190082645,"2010"
"388","2013_2010_roe","roe",2,2,"2013_2010",2013,"f","day",116,8,104,4,0,8,108,12,104,0.0689655172413793,0.896551724137931,0.0344827586206897,0,0.0689655172413793,0.931034482758621,0.103448275862069,0.896551724137931,"2010"
"389","2014_2010_roe","roe",2,2,"2014_2010",2014,"m","night",121,94,22,4,1,95,26,98,23,0.776859504132231,0.181818181818182,0.0330578512396694,0.00826446280991736,0.785123966942149,0.214876033057851,0.809917355371901,0.190082644628099,"2010"
"390","2014_2010_roe","roe",2,2,"2014_2010",2014,"m","day",120,27,88,1,4,31,89,28,92,0.225,0.733333333333333,0.00833333333333333,0.0333333333333333,0.258333333333333,0.741666666666667,0.233333333333333,0.766666666666667,"2010"
"391","2014_2011_roe","roe",2,2,"2014_2011",2014,"m","night",120,98,14,8,0,98,22,106,14,0.816666666666667,0.116666666666667,0.0666666666666667,0,0.816666666666667,0.183333333333333,0.883333333333333,0.116666666666667,"2011"
"392","2014_2011_roe","roe",2,2,"2014_2011",2014,"m","day",118,21,83,14,0,21,97,35,83,0.177966101694915,0.703389830508475,0.11864406779661,0,0.177966101694915,0.822033898305085,0.296610169491525,0.703389830508475,"2011"
"399","2030_2010_roe","roe",2,2,"2030_2010",2030,"m","night",115,102,10,3,0,102,13,105,10,0.88695652173913,0.0869565217391304,0.0260869565217391,0,0.88695652173913,0.11304347826087,0.91304347826087,0.0869565217391304,"2010"
"400","2030_2010_roe","roe",2,2,"2030_2010",2030,"m","day",117,56,48,13,0,56,61,69,48,0.478632478632479,0.41025641025641,0.111111111111111,0,0.478632478632479,0.521367521367521,0.58974358974359,0.41025641025641,"2010"
"405","2041_2011_roe","roe",15,15,"2041_2011",2041,"f","night",185,170,13,2,0,170,15,172,13,0.918918918918919,0.0702702702702703,0.0108108108108108,0,0.918918918918919,0.0810810810810811,0.92972972972973,0.0702702702702703,"2011"
"406","2041_2011_roe","roe",15,15,"2041_2011",2041,"f","day",184,138,42,1,3,141,43,139,45,0.75,0.228260869565217,0.00543478260869565,0.016304347826087,0.766304347826087,0.233695652173913,0.755434782608696,0.244565217391304,"2011"
"407","2043_2011_roe","roe",15,15,"2043_2011",2043,"f","night",185,178,0,7,0,178,7,185,0,0.962162162162162,0,0.0378378378378378,0,0.962162162162162,0.0378378378378378,1,0,"2011"
"408","2043_2011_roe","roe",15,15,"2043_2011",2043,"f","day",184,174,2,7,1,175,9,181,3,0.945652173913043,0.0108695652173913,0.0380434782608696,0.00543478260869565,0.951086956521739,0.0489130434782609,0.983695652173913,0.016304347826087,"2011"
"409","2044_2011_roe","roe",15,15,"2044_2011",2044,"f","night",185,26,85,0,74,100,85,26,159,0.140540540540541,0.459459459459459,0,0.4,0.540540540540541,0.459459459459459,0.140540540540541,0.859459459459459,"2011"
"410","2044_2011_roe","roe",15,15,"2044_2011",2044,"f","day",184,1,145,0,38,39,145,1,183,0.00543478260869565,0.78804347826087,0,0.206521739130435,0.21195652173913,0.78804347826087,0.00543478260869565,0.994565217391304,"2011"
"411","2045_2011_roe","roe",15,15,"2045_2011",2045,"f","night",185,159,0,26,0,159,26,185,0,0.859459459459459,0,0.140540540540541,0,0.859459459459459,0.140540540540541,1,0,"2011"
"412","2045_2011_roe","roe",15,15,"2045_2011",2045,"f","day",184,142,0,42,0,142,42,184,0,0.771739130434783,0,0.228260869565217,0,0.771739130434783,0.228260869565217,1,0,"2011"
"413","2046_2011_roe","roe",15,15,"2046_2011",2046,"f","night",185,172,0,13,0,172,13,185,0,0.92972972972973,0,0.0702702702702703,0,0.92972972972973,0.0702702702702703,1,0,"2011"
"414","2046_2011_roe","roe",15,15,"2046_2011",2046,"f","day",184,132,1,51,0,132,52,183,1,0.717391304347826,0.00543478260869565,0.277173913043478,0,0.717391304347826,0.282608695652174,0.994565217391304,0.00543478260869565,"2011"
"415","2047_2011_roe","roe",15,15,"2047_2011",2047,"m","night",184,43,65,0,76,119,65,43,141,0.233695652173913,0.353260869565217,0,0.41304347826087,0.646739130434783,0.353260869565217,0.233695652173913,0.766304347826087,"2011"
"416","2047_2011_roe","roe",15,15,"2047_2011",2047,"m","day",182,36,117,0,29,65,117,36,146,0.197802197802198,0.642857142857143,0,0.159340659340659,0.357142857142857,0.642857142857143,0.197802197802198,0.802197802197802,"2011"
"417","2047_2012_roe","roe",15,15,"2047_2012",2047,"m","night",183,61,57,0,65,126,57,61,122,0.333333333333333,0.311475409836066,0,0.355191256830601,0.688524590163934,0.311475409836066,0.333333333333333,0.666666666666667,"2012"
"418","2047_2012_roe","roe",15,15,"2047_2012",2047,"m","day",180,58,65,2,55,113,67,60,120,0.322222222222222,0.361111111111111,0.0111111111111111,0.305555555555556,0.627777777777778,0.372222222222222,0.333333333333333,0.666666666666667,"2012"
"419","2048_2011_roe","roe",15,15,"2048_2011",2048,"m","night",185,179,0,5,1,180,5,184,1,0.967567567567568,0,0.027027027027027,0.00540540540540541,0.972972972972973,0.027027027027027,0.994594594594595,0.00540540540540541,"2011"
"420","2048_2011_roe","roe",15,15,"2048_2011",2048,"m","day",184,152,15,14,3,155,29,166,18,0.826086956521739,0.0815217391304348,0.0760869565217391,0.016304347826087,0.842391304347826,0.157608695652174,0.902173913043478,0.0978260869565217,"2011"
"421","2049_2011_roe","roe",15,15,"2049_2011",2049,"f","night",185,61,50,4,70,131,54,65,120,0.32972972972973,0.27027027027027,0.0216216216216216,0.378378378378378,0.708108108108108,0.291891891891892,0.351351351351351,0.648648648648649,"2011"
"422","2049_2011_roe","roe",15,15,"2049_2011",2049,"f","day",184,95,73,1,15,110,74,96,88,0.516304347826087,0.396739130434783,0.00543478260869565,0.0815217391304348,0.597826086956522,0.402173913043478,0.521739130434783,0.478260869565217,"2011"
"423","2054_2012_roe","roe",15,15,"2054_2012",2054,"f","night",181,175,2,0,4,179,2,175,6,0.966850828729282,0.0110497237569061,0,0.0220994475138122,0.988950276243094,0.0110497237569061,0.966850828729282,0.0331491712707182,"2012"
"424","2054_2012_roe","roe",15,15,"2054_2012",2054,"f","day",180,163,12,0,5,168,12,163,17,0.905555555555556,0.0666666666666667,0,0.0277777777777778,0.933333333333333,0.0666666666666667,0.905555555555556,0.0944444444444444,"2012"
"425","2054_2013_roe","roe",15,15,"2054_2013",2054,"f","night",185,183,1,0,1,184,1,183,2,0.989189189189189,0.00540540540540541,0,0.00540540540540541,0.994594594594595,0.00540540540540541,0.989189189189189,0.0108108108108108,"2013"
"426","2054_2013_roe","roe",15,15,"2054_2013",2054,"f","day",184,175,4,0,5,180,4,175,9,0.951086956521739,0.0217391304347826,0,0.0271739130434783,0.978260869565217,0.0217391304347826,0.951086956521739,0.0489130434782609,"2013"
"427","2055_2012_roe","roe",15,15,"2055_2012",2055,"f","night",185,170,0,15,0,170,15,185,0,0.918918918918919,0,0.0810810810810811,0,0.918918918918919,0.0810810810810811,1,0,"2012"
"428","2055_2012_roe","roe",15,15,"2055_2012",2055,"f","day",184,143,0,41,0,143,41,184,0,0.777173913043478,0,0.222826086956522,0,0.777173913043478,0.222826086956522,1,0,"2012"
"429","2056_2012_roe","roe",15,15,"2056_2012",2056,"f","night",185,171,0,13,1,172,13,184,1,0.924324324324324,0,0.0702702702702703,0.00540540540540541,0.92972972972973,0.0702702702702703,0.994594594594595,0.00540540540540541,"2012"
"430","2056_2012_roe","roe",15,15,"2056_2012",2056,"f","day",183,160,1,22,0,160,23,182,1,0.87431693989071,0.00546448087431694,0.120218579234973,0,0.87431693989071,0.12568306010929,0.994535519125683,0.00546448087431694,"2012"
"431","2056_2013_roe","roe",15,15,"2056_2013",2056,"f","night",185,169,0,16,0,169,16,185,0,0.913513513513514,0,0.0864864864864865,0,0.913513513513514,0.0864864864864865,1,0,"2013"
"432","2056_2013_roe","roe",15,15,"2056_2013",2056,"f","day",183,113,1,69,0,113,70,182,1,0.617486338797814,0.00546448087431694,0.377049180327869,0,0.617486338797814,0.382513661202186,0.994535519125683,0.00546448087431694,"2013"
"433","2065_2012_roe","roe",15,15,"2065_2012",2065,"m","night",183,179,2,0,2,181,2,179,4,0.978142076502732,0.0109289617486339,0,0.0109289617486339,0.989071038251366,0.0109289617486339,0.978142076502732,0.0218579234972678,"2012"
"434","2065_2012_roe","roe",15,15,"2065_2012",2065,"m","day",183,156,23,0,4,160,23,156,27,0.852459016393443,0.12568306010929,0,0.0218579234972678,0.87431693989071,0.12568306010929,0.852459016393443,0.147540983606557,"2012"
"435","2066_2012_roe","roe",15,15,"2066_2012",2066,"f","night",175,157,17,1,0,157,18,158,17,0.897142857142857,0.0971428571428571,0.00571428571428571,0,0.897142857142857,0.102857142857143,0.902857142857143,0.0971428571428571,"2012"
"436","2066_2012_roe","roe",15,15,"2066_2012",2066,"f","day",175,156,18,1,0,156,19,157,18,0.891428571428571,0.102857142857143,0.00571428571428571,0,0.891428571428571,0.108571428571429,0.897142857142857,0.102857142857143,"2012"
"437","2067_2012_roe","roe",15,15,"2067_2012",2067,"f","night",179,173,3,0,3,176,3,173,6,0.966480446927374,0.0167597765363128,0,0.0167597765363128,0.983240223463687,0.0167597765363128,0.966480446927374,0.0335195530726257,"2012"
"438","2067_2012_roe","roe",15,15,"2067_2012",2067,"f","day",180,164,7,6,3,167,13,170,10,0.911111111111111,0.0388888888888889,0.0333333333333333,0.0166666666666667,0.927777777777778,0.0722222222222222,0.944444444444444,0.0555555555555556,"2012"
"439","2068_2012_roe","roe",15,15,"2068_2012",2068,"m","night",181,103,73,0,5,108,73,103,78,0.569060773480663,0.403314917127072,0,0.0276243093922652,0.596685082872928,0.403314917127072,0.569060773480663,0.430939226519337,"2012"
"440","2068_2012_roe","roe",15,15,"2068_2012",2068,"m","day",181,60,118,1,2,62,119,61,120,0.331491712707182,0.651933701657459,0.00552486187845304,0.0110497237569061,0.342541436464088,0.657458563535912,0.337016574585635,0.662983425414365,"2012"
"441","2072_2012_roe","roe",15,15,"2072_2012",2072,"f","night",185,174,2,4,5,179,6,178,7,0.940540540540541,0.0108108108108108,0.0216216216216216,0.027027027027027,0.967567567567568,0.0324324324324324,0.962162162162162,0.0378378378378378,"2012"
"442","2072_2012_roe","roe",15,15,"2072_2012",2072,"f","day",184,136,32,1,15,151,33,137,47,0.739130434782609,0.173913043478261,0.00543478260869565,0.0815217391304348,0.820652173913043,0.179347826086957,0.744565217391304,0.255434782608696,"2012"
"443","2072_2013_roe","roe",15,15,"2072_2013",2072,"f","night",185,146,34,2,3,149,36,148,37,0.789189189189189,0.183783783783784,0.0108108108108108,0.0162162162162162,0.805405405405405,0.194594594594595,0.8,0.2,"2013"
"444","2072_2013_roe","roe",15,15,"2072_2013",2072,"f","day",184,118,43,0,23,141,43,118,66,0.641304347826087,0.233695652173913,0,0.125,0.766304347826087,0.233695652173913,0.641304347826087,0.358695652173913,"2013"
"445","2076_2012_roe","roe",15,15,"2076_2012",2076,"f","night",181,85,89,0,7,92,89,85,96,0.469613259668508,0.49171270718232,0,0.0386740331491713,0.50828729281768,0.49171270718232,0.469613259668508,0.530386740331492,"2012"
"446","2076_2012_roe","roe",15,15,"2076_2012",2076,"f","day",180,5,168,1,6,11,169,6,174,0.0277777777777778,0.933333333333333,0.00555555555555556,0.0333333333333333,0.0611111111111111,0.938888888888889,0.0333333333333333,0.966666666666667,"2012"
"447","2076_2013_roe","roe",15,15,"2076_2013",2076,"f","night",185,117,55,3,10,127,58,120,65,0.632432432432432,0.297297297297297,0.0162162162162162,0.0540540540540541,0.686486486486486,0.313513513513514,0.648648648648649,0.351351351351351,"2013"
"448","2076_2013_roe","roe",15,15,"2076_2013",2076,"f","day",184,14,155,1,14,28,156,15,169,0.0760869565217391,0.842391304347826,0.00543478260869565,0.0760869565217391,0.152173913043478,0.847826086956522,0.0815217391304348,0.918478260869565,"2013"
"449","2078_2012_roe","roe",15,15,"2078_2012",2078,"f","night",185,178,0,1,6,184,1,179,6,0.962162162162162,0,0.00540540540540541,0.0324324324324324,0.994594594594595,0.00540540540540541,0.967567567567568,0.0324324324324324,"2012"
"450","2078_2012_roe","roe",15,15,"2078_2012",2078,"f","day",182,112,15,1,54,166,16,113,69,0.615384615384615,0.0824175824175824,0.00549450549450549,0.296703296703297,0.912087912087912,0.0879120879120879,0.620879120879121,0.379120879120879,"2012"
"451","2078_2013_roe","roe",15,15,"2078_2013",2078,"f","night",184,179,0,0,5,184,0,179,5,0.972826086956522,0,0,0.0271739130434783,1,0,0.972826086956522,0.0271739130434783,"2013"
"452","2078_2013_roe","roe",15,15,"2078_2013",2078,"f","day",184,100,7,0,77,177,7,100,84,0.543478260869565,0.0380434782608696,0,0.418478260869565,0.96195652173913,0.0380434782608696,0.543478260869565,0.456521739130435,"2013"
"453","2079_2012_roe","roe",15,15,"2079_2012",2079,"f","night",185,178,5,1,1,179,6,179,6,0.962162162162162,0.027027027027027,0.00540540540540541,0.00540540540540541,0.967567567567568,0.0324324324324324,0.967567567567568,0.0324324324324324,"2012"
"454","2079_2012_roe","roe",15,15,"2079_2012",2079,"f","day",183,171,4,0,8,179,4,171,12,0.934426229508197,0.0218579234972678,0,0.0437158469945355,0.978142076502732,0.0218579234972678,0.934426229508197,0.0655737704918033,"2012"
"455","2081_2013_roe","roe",15,15,"2081_2013",2081,"m","night",185,184,0,1,0,184,1,185,0,0.994594594594595,0,0.00540540540540541,0,0.994594594594595,0.00540540540540541,1,0,"2013"
"456","2081_2013_roe","roe",15,15,"2081_2013",2081,"m","day",182,176,0,0,6,182,0,176,6,0.967032967032967,0,0,0.032967032967033,1,0,0.967032967032967,0.032967032967033,"2013"
"457","21_2010_roe","roe",2,2,"21_2010",21,"m","night",116,0,59,0,57,57,59,0,116,0,0.508620689655172,0,0.491379310344828,0.491379310344828,0.508620689655172,0,1,"2010"
"458","21_2010_roe","roe",2,2,"21_2010",21,"m","day",115,0,106,0,9,9,106,0,115,0,0.921739130434783,0,0.0782608695652174,0.0782608695652174,0.921739130434783,0,1,"2010"
"479","2246_2013_roe","roe",25,25,"2246_2013",2246,"f","night",184,122,22,12,28,150,34,134,50,0.66304347826087,0.119565217391304,0.0652173913043478,0.152173913043478,0.815217391304348,0.184782608695652,0.728260869565217,0.271739130434783,"2013"
"480","2246_2013_roe","roe",25,25,"2246_2013",2246,"f","day",184,48,59,20,57,105,79,68,116,0.260869565217391,0.320652173913043,0.108695652173913,0.309782608695652,0.570652173913043,0.429347826086957,0.369565217391304,0.630434782608696,"2013"
"481","2246_2014_roe","roe",25,25,"2246_2014",2246,"f","night",185,133,12,6,34,167,18,139,46,0.718918918918919,0.0648648648648649,0.0324324324324324,0.183783783783784,0.902702702702703,0.0972972972972973,0.751351351351351,0.248648648648649,"2014"
"482","2246_2014_roe","roe",25,25,"2246_2014",2246,"f","day",184,78,37,14,55,133,51,92,92,0.423913043478261,0.201086956521739,0.0760869565217391,0.298913043478261,0.722826086956522,0.277173913043478,0.5,0.5,"2014"
"499","2252_2013_roe","roe",25,25,"2252_2013",2252,"f","night",185,167,7,10,1,168,17,177,8,0.902702702702703,0.0378378378378378,0.0540540540540541,0.00540540540540541,0.908108108108108,0.0918918918918919,0.956756756756757,0.0432432432432432,"2013"
"500","2252_2013_roe","roe",25,25,"2252_2013",2252,"f","day",184,46,102,23,13,59,125,69,115,0.25,0.554347826086957,0.125,0.0706521739130435,0.320652173913043,0.679347826086957,0.375,0.625,"2013"
"501","2252_2014_roe","roe",25,25,"2252_2014",2252,"f","night",177,168,1,8,0,168,9,176,1,0.949152542372881,0.00564971751412429,0.0451977401129944,0,0.949152542372881,0.0508474576271186,0.994350282485876,0.00564971751412429,"2014"
"502","2252_2014_roe","roe",25,25,"2252_2014",2252,"f","day",176,71,61,28,16,87,89,99,77,0.403409090909091,0.346590909090909,0.159090909090909,0.0909090909090909,0.494318181818182,0.505681818181818,0.5625,0.4375,"2014"
"505","2256_2013_roe","roe",25,25,"2256_2013",2256,"f","night",185,103,42,27,13,116,69,130,55,0.556756756756757,0.227027027027027,0.145945945945946,0.0702702702702703,0.627027027027027,0.372972972972973,0.702702702702703,0.297297297297297,"2013"
"506","2256_2013_roe","roe",25,25,"2256_2013",2256,"f","day",184,17,104,48,15,32,152,65,119,0.0923913043478261,0.565217391304348,0.260869565217391,0.0815217391304348,0.173913043478261,0.826086956521739,0.353260869565217,0.646739130434783,"2013"
"507","2256_2014_roe","roe",25,25,"2256_2014",2256,"f","night",185,96,40,17,32,128,57,113,72,0.518918918918919,0.216216216216216,0.0918918918918919,0.172972972972973,0.691891891891892,0.308108108108108,0.610810810810811,0.389189189189189,"2014"
"508","2256_2014_roe","roe",25,25,"2256_2014",2256,"f","day",182,11,118,19,34,45,137,30,152,0.0604395604395604,0.648351648351648,0.104395604395604,0.186813186813187,0.247252747252747,0.752747252747253,0.164835164835165,0.835164835164835,"2014"
"509","2259_2013_roe","roe",25,25,"2259_2013",2259,"f","night",185,170,3,4,8,178,7,174,11,0.918918918918919,0.0162162162162162,0.0216216216216216,0.0432432432432432,0.962162162162162,0.0378378378378378,0.940540540540541,0.0594594594594595,"2013"
"510","2259_2013_roe","roe",25,25,"2259_2013",2259,"f","day",184,54,48,13,69,123,61,67,117,0.293478260869565,0.260869565217391,0.0706521739130435,0.375,0.668478260869565,0.331521739130435,0.364130434782609,0.635869565217391,"2013"
"511","2259_2014_roe","roe",25,25,"2259_2014",2259,"f","night",185,175,1,0,9,184,1,175,10,0.945945945945946,0.00540540540540541,0,0.0486486486486487,0.994594594594595,0.00540540540540541,0.945945945945946,0.0540540540540541,"2014"
"512","2259_2014_roe","roe",25,25,"2259_2014",2259,"f","day",183,47,31,13,92,139,44,60,123,0.256830601092896,0.169398907103825,0.0710382513661202,0.502732240437158,0.759562841530055,0.240437158469945,0.327868852459016,0.672131147540984,"2014"
"515","2264_2013_roe","roe",25,25,"2264_2013",2264,"f","night",185,181,0,1,3,184,1,182,3,0.978378378378378,0,0.00540540540540541,0.0162162162162162,0.994594594594595,0.00540540540540541,0.983783783783784,0.0162162162162162,"2013"
"516","2264_2013_roe","roe",25,25,"2264_2013",2264,"f","day",184,144,4,4,32,176,8,148,36,0.782608695652174,0.0217391304347826,0.0217391304347826,0.173913043478261,0.956521739130435,0.0434782608695652,0.804347826086957,0.195652173913043,"2013"
"517","2264_2014_roe","roe",25,25,"2264_2014",2264,"f","night",185,177,1,0,7,184,1,177,8,0.956756756756757,0.00540540540540541,0,0.0378378378378378,0.994594594594595,0.00540540540540541,0.956756756756757,0.0432432432432432,"2014"
"518","2264_2014_roe","roe",25,25,"2264_2014",2264,"f","day",183,111,7,0,65,176,7,111,72,0.60655737704918,0.0382513661202186,0,0.355191256830601,0.961748633879781,0.0382513661202186,0.60655737704918,0.39344262295082,"2014"
"521","2265_2014_roe","roe",25,25,"2265_2014",2265,"f","night",183,141,11,31,0,141,42,172,11,0.770491803278688,0.0601092896174863,0.169398907103825,0,0.770491803278688,0.229508196721311,0.939890710382514,0.0601092896174863,"2014"
"522","2265_2014_roe","roe",25,25,"2265_2014",2265,"f","day",183,21,45,117,0,21,162,138,45,0.114754098360656,0.245901639344262,0.639344262295082,0,0.114754098360656,0.885245901639344,0.754098360655738,0.245901639344262,"2014"
"523","2266_2013_roe","roe",25,25,"2266_2013",2266,"m","night",185,169,2,2,12,181,4,171,14,0.913513513513514,0.0108108108108108,0.0108108108108108,0.0648648648648649,0.978378378378378,0.0216216216216216,0.924324324324324,0.0756756756756757,"2013"
"524","2266_2013_roe","roe",25,25,"2266_2013",2266,"m","day",184,57,84,6,37,94,90,63,121,0.309782608695652,0.456521739130435,0.0326086956521739,0.201086956521739,0.510869565217391,0.489130434782609,0.342391304347826,0.657608695652174,"2013"
"525","2266_2014_roe","roe",25,25,"2266_2014",2266,"m","night",185,171,3,4,7,178,7,175,10,0.924324324324324,0.0162162162162162,0.0216216216216216,0.0378378378378378,0.962162162162162,0.0378378378378378,0.945945945945946,0.0540540540540541,"2014"
"526","2266_2014_roe","roe",25,25,"2266_2014",2266,"m","day",183,44,84,22,33,77,106,66,117,0.240437158469945,0.459016393442623,0.120218579234973,0.180327868852459,0.420765027322404,0.579234972677596,0.360655737704918,0.639344262295082,"2014"
"527","2267_2013_roe","roe",25,25,"2267_2013",2267,"f","night",185,182,0,3,0,182,3,185,0,0.983783783783784,0,0.0162162162162162,0,0.983783783783784,0.0162162162162162,1,0,"2013"
"528","2267_2013_roe","roe",25,25,"2267_2013",2267,"f","day",184,138,3,43,0,138,46,181,3,0.75,0.016304347826087,0.233695652173913,0,0.75,0.25,0.983695652173913,0.016304347826087,"2013"
"529","2267_2014_roe","roe",25,25,"2267_2014",2267,"f","night",185,184,0,1,0,184,1,185,0,0.994594594594595,0,0.00540540540540541,0,0.994594594594595,0.00540540540540541,1,0,"2014"
"530","2267_2014_roe","roe",25,25,"2267_2014",2267,"f","day",184,149,3,32,0,149,35,181,3,0.809782608695652,0.016304347826087,0.173913043478261,0,0.809782608695652,0.190217391304348,0.983695652173913,0.016304347826087,"2014"
"531","2274_2013_roe","roe",25,25,"2274_2013",2274,"f","night",185,112,50,15,8,120,65,127,58,0.605405405405405,0.27027027027027,0.0810810810810811,0.0432432432432432,0.648648648648649,0.351351351351351,0.686486486486486,0.313513513513514,"2013"
"532","2274_2013_roe","roe",25,25,"2274_2013",2274,"f","day",184,23,135,14,12,35,149,37,147,0.125,0.733695652173913,0.0760869565217391,0.0652173913043478,0.190217391304348,0.809782608695652,0.201086956521739,0.798913043478261,"2013"
"533","2274_2014_roe","roe",25,25,"2274_2014",2274,"f","night",185,107,54,11,13,120,65,118,67,0.578378378378378,0.291891891891892,0.0594594594594595,0.0702702702702703,0.648648648648649,0.351351351351351,0.637837837837838,0.362162162162162,"2014"
"534","2274_2014_roe","roe",25,25,"2274_2014",2274,"f","day",184,30,131,11,12,42,142,41,143,0.16304347826087,0.71195652173913,0.0597826086956522,0.0652173913043478,0.228260869565217,0.771739130434783,0.222826086956522,0.777173913043478,"2014"
"535","2279_2013_roe","roe",25,25,"2279_2013",2279,"m","night",185,113,29,13,30,143,42,126,59,0.610810810810811,0.156756756756757,0.0702702702702703,0.162162162162162,0.772972972972973,0.227027027027027,0.681081081081081,0.318918918918919,"2013"
"536","2279_2013_roe","roe",25,25,"2279_2013",2279,"m","day",183,5,157,8,13,18,165,13,170,0.0273224043715847,0.85792349726776,0.0437158469945355,0.0710382513661202,0.0983606557377049,0.901639344262295,0.0710382513661202,0.92896174863388,"2013"
"537","2279_2014_roe","roe",25,25,"2279_2014",2279,"m","night",185,138,20,13,14,152,33,151,34,0.745945945945946,0.108108108108108,0.0702702702702703,0.0756756756756757,0.821621621621622,0.178378378378378,0.816216216216216,0.183783783783784,"2014"
"538","2279_2014_roe","roe",25,25,"2279_2014",2279,"m","day",184,21,144,10,9,30,154,31,153,0.114130434782609,0.782608695652174,0.0543478260869565,0.0489130434782609,0.16304347826087,0.83695652173913,0.168478260869565,0.831521739130435,"2014"
"539","2281_2013_roe","roe",25,25,"2281_2013",2281,"f","night",185,33,7,0,145,178,7,33,152,0.178378378378378,0.0378378378378378,0,0.783783783783784,0.962162162162162,0.0378378378378378,0.178378378378378,0.821621621621622,"2013"
"540","2281_2013_roe","roe",25,25,"2281_2013",2281,"f","day",183,7,33,1,142,149,34,8,175,0.0382513661202186,0.180327868852459,0.00546448087431694,0.775956284153005,0.814207650273224,0.185792349726776,0.0437158469945355,0.956284153005464,"2013"
"541","2281_2014_roe","roe",25,25,"2281_2014",2281,"f","night",185,108,36,7,34,142,43,115,70,0.583783783783784,0.194594594594595,0.0378378378378378,0.183783783783784,0.767567567567568,0.232432432432432,0.621621621621622,0.378378378378378,"2014"
"542","2281_2014_roe","roe",25,25,"2281_2014",2281,"f","day",184,25,88,4,67,92,92,29,155,0.135869565217391,0.478260869565217,0.0217391304347826,0.364130434782609,0.5,0.5,0.157608695652174,0.842391304347826,"2014"
"543","2282_2013_roe","roe",25,25,"2282_2013",2282,"f","night",185,111,65,8,1,112,73,119,66,0.6,0.351351351351351,0.0432432432432432,0.00540540540540541,0.605405405405405,0.394594594594595,0.643243243243243,0.356756756756757,"2013"
"544","2282_2013_roe","roe",25,25,"2282_2013",2282,"f","day",184,2,177,4,1,3,181,6,178,0.0108695652173913,0.96195652173913,0.0217391304347826,0.00543478260869565,0.016304347826087,0.983695652173913,0.0326086956521739,0.967391304347826,"2013"
"545","2282_2014_roe","roe",25,25,"2282_2014",2282,"f","night",185,98,60,25,2,100,85,123,62,0.52972972972973,0.324324324324324,0.135135135135135,0.0108108108108108,0.540540540540541,0.459459459459459,0.664864864864865,0.335135135135135,"2014"
"546","2282_2014_roe","roe",25,25,"2282_2014",2282,"f","day",183,1,169,12,1,2,181,13,170,0.00546448087431694,0.923497267759563,0.0655737704918033,0.00546448087431694,0.0109289617486339,0.989071038251366,0.0710382513661202,0.92896174863388,"2014"
"559","2290_2014_roe","roe",25,25,"2290_2014",2290,"m","night",185,145,16,5,19,164,21,150,35,0.783783783783784,0.0864864864864865,0.027027027027027,0.102702702702703,0.886486486486487,0.113513513513514,0.810810810810811,0.189189189189189,"2014"
"560","2290_2014_roe","roe",25,25,"2290_2014",2290,"m","day",184,33,73,22,56,89,95,55,129,0.179347826086957,0.396739130434783,0.119565217391304,0.304347826086957,0.483695652173913,0.516304347826087,0.298913043478261,0.701086956521739,"2014"
"561","2292_2013_roe","roe",25,25,"2292_2013",2292,"m","night",181,137,22,11,11,148,33,148,33,0.756906077348066,0.121546961325967,0.0607734806629834,0.0607734806629834,0.81767955801105,0.18232044198895,0.81767955801105,0.18232044198895,"2013"
"562","2292_2013_roe","roe",25,25,"2292_2013",2292,"m","day",182,72,63,12,35,107,75,84,98,0.395604395604396,0.346153846153846,0.0659340659340659,0.192307692307692,0.587912087912088,0.412087912087912,0.461538461538462,0.538461538461538,"2013"
"563","2292_2014_roe","roe",25,25,"2292_2014",2292,"m","night",185,153,13,15,4,157,28,168,17,0.827027027027027,0.0702702702702703,0.0810810810810811,0.0216216216216216,0.848648648648649,0.151351351351351,0.908108108108108,0.0918918918918919,"2014"
"564","2292_2014_roe","roe",25,25,"2292_2014",2292,"m","day",184,59,59,52,14,73,111,111,73,0.320652173913043,0.320652173913043,0.282608695652174,0.0760869565217391,0.396739130434783,0.603260869565217,0.603260869565217,0.396739130434783,"2014"
"567","2295_2013_roe","roe",25,25,"2295_2013",2295,"f","night",185,88,51,17,29,117,68,105,80,0.475675675675676,0.275675675675676,0.0918918918918919,0.156756756756757,0.632432432432432,0.367567567567568,0.567567567567568,0.432432432432432,"2013"
"568","2295_2013_roe","roe",25,25,"2295_2013",2295,"f","day",184,15,114,41,14,29,155,56,128,0.0815217391304348,0.619565217391304,0.222826086956522,0.0760869565217391,0.157608695652174,0.842391304347826,0.304347826086957,0.695652173913043,"2013"
"569","2295_2014_roe","roe",25,25,"2295_2014",2295,"f","night",185,125,26,15,19,144,41,140,45,0.675675675675676,0.140540540540541,0.0810810810810811,0.102702702702703,0.778378378378378,0.221621621621622,0.756756756756757,0.243243243243243,"2014"
"570","2295_2014_roe","roe",25,25,"2295_2014",2295,"f","day",184,21,123,18,22,43,141,39,145,0.114130434782609,0.668478260869565,0.0978260869565217,0.119565217391304,0.233695652173913,0.766304347826087,0.21195652173913,0.78804347826087,"2014"
"581","2301_2013_roe","roe",25,25,"2301_2013",2301,"f","night",185,180,0,4,1,181,4,184,1,0.972972972972973,0,0.0216216216216216,0.00540540540540541,0.978378378378378,0.0216216216216216,0.994594594594595,0.00540540540540541,"2013"
"582","2301_2013_roe","roe",25,25,"2301_2013",2301,"f","day",184,165,1,12,6,171,13,177,7,0.896739130434783,0.00543478260869565,0.0652173913043478,0.0326086956521739,0.929347826086957,0.0706521739130435,0.96195652173913,0.0380434782608696,"2013"
"583","2301_2014_roe","roe",25,25,"2301_2014",2301,"f","night",185,177,0,8,0,177,8,185,0,0.956756756756757,0,0.0432432432432432,0,0.956756756756757,0.0432432432432432,1,0,"2014"
"584","2301_2014_roe","roe",25,25,"2301_2014",2301,"f","day",184,151,1,29,3,154,30,180,4,0.820652173913043,0.00543478260869565,0.157608695652174,0.016304347826087,0.83695652173913,0.16304347826087,0.978260869565217,0.0217391304347826,"2014"
"585","2302_2013_roe","roe",25,25,"2302_2013",2302,"m","night",185,128,22,5,30,158,27,133,52,0.691891891891892,0.118918918918919,0.027027027027027,0.162162162162162,0.854054054054054,0.145945945945946,0.718918918918919,0.281081081081081,"2013"
"586","2302_2013_roe","roe",25,25,"2302_2013",2302,"m","day",184,34,84,12,54,88,96,46,138,0.184782608695652,0.456521739130435,0.0652173913043478,0.293478260869565,0.478260869565217,0.521739130434783,0.25,0.75,"2013"
"587","2302_2014_roe","roe",25,25,"2302_2014",2302,"m","night",185,146,10,2,27,173,12,148,37,0.789189189189189,0.0540540540540541,0.0108108108108108,0.145945945945946,0.935135135135135,0.0648648648648649,0.8,0.2,"2014"
"588","2302_2014_roe","roe",25,25,"2302_2014",2302,"m","day",184,41,72,17,54,95,89,58,126,0.222826086956522,0.391304347826087,0.0923913043478261,0.293478260869565,0.516304347826087,0.483695652173913,0.315217391304348,0.684782608695652,"2014"
"633","769_2005_roe","roe",1,1,"769_2005",769,"m","night",122,5,117,0,0,5,117,5,117,0.040983606557377,0.959016393442623,0,0,0.040983606557377,0.959016393442623,0.040983606557377,0.959016393442623,"2005"
"634","769_2005_roe","roe",1,1,"769_2005",769,"m","day",116,0,116,0,0,0,116,0,116,0,1,0,0,0,1,0,1,"2005"
"635","770_2005_roe","roe",1,1,"770_2005",770,"m","night",112,2,54,53,3,5,107,55,57,0.0178571428571429,0.482142857142857,0.473214285714286,0.0267857142857143,0.0446428571428571,0.955357142857143,0.491071428571429,0.508928571428571,"2005"
"636","770_2005_roe","roe",1,1,"770_2005",770,"m","day",130,10,57,63,0,10,120,73,57,0.0769230769230769,0.438461538461538,0.484615384615385,0,0.0769230769230769,0.923076923076923,0.561538461538462,0.438461538461538,"2005"
"637","771_2005_roe","roe",1,1,"771_2005",771,"m","night",161,11,88,53,9,20,141,64,97,0.0683229813664596,0.546583850931677,0.329192546583851,0.0559006211180124,0.124223602484472,0.875776397515528,0.397515527950311,0.602484472049689,"2005"
"638","771_2005_roe","roe",1,1,"771_2005",771,"m","day",135,2,120,11,2,4,131,13,122,0.0148148148148148,0.888888888888889,0.0814814814814815,0.0148148148148148,0.0296296296296296,0.97037037037037,0.0962962962962963,0.903703703703704,"2005"
"639","772_2005_roe","roe",1,1,"772_2005",772,"m","night",136,109,10,7,10,119,17,116,20,0.801470588235294,0.0735294117647059,0.0514705882352941,0.0735294117647059,0.875,0.125,0.852941176470588,0.147058823529412,"2005"
"640","772_2005_roe","roe",1,1,"772_2005",772,"m","day",98,5,68,7,18,23,75,12,86,0.0510204081632653,0.693877551020408,0.0714285714285714,0.183673469387755,0.23469387755102,0.76530612244898,0.122448979591837,0.877551020408163,"2005"
"641","774_2006_roe","roe",1,1,"774_2006",774,"m","night",175,99,17,54,5,104,71,153,22,0.565714285714286,0.0971428571428571,0.308571428571429,0.0285714285714286,0.594285714285714,0.405714285714286,0.874285714285714,0.125714285714286,"2006"
"642","774_2006_roe","roe",1,1,"774_2006",774,"m","day",128,23,85,15,5,28,100,38,90,0.1796875,0.6640625,0.1171875,0.0390625,0.21875,0.78125,0.296875,0.703125,"2006"
"643","774_2007_roe","roe",1,1,"774_2007",774,"m","night",158,86,7,64,1,87,71,150,8,0.544303797468354,0.0443037974683544,0.40506329113924,0.00632911392405063,0.550632911392405,0.449367088607595,0.949367088607595,0.0506329113924051,"2007"
"644","774_2007_roe","roe",1,1,"774_2007",774,"m","day",129,23,56,49,1,24,105,72,57,0.178294573643411,0.434108527131783,0.37984496124031,0.00775193798449612,0.186046511627907,0.813953488372093,0.558139534883721,0.441860465116279,"2007"
"645","776_2006_roe","roe",1,1,"776_2006",776,"m","night",164,22,75,60,7,29,135,82,82,0.134146341463415,0.457317073170732,0.365853658536585,0.0426829268292683,0.176829268292683,0.823170731707317,0.5,0.5,"2006"
"646","776_2006_roe","roe",1,1,"776_2006",776,"m","day",132,12,66,49,5,17,115,61,71,0.0909090909090909,0.5,0.371212121212121,0.0378787878787879,0.128787878787879,0.871212121212121,0.462121212121212,0.537878787878788,"2006"
"647","782_2006_roe","roe",1,1,"782_2006",782,"f","night",166,99,33,33,1,100,66,132,34,0.596385542168675,0.198795180722892,0.198795180722892,0.00602409638554217,0.602409638554217,0.397590361445783,0.795180722891566,0.204819277108434,"2006"
"648","782_2006_roe","roe",1,1,"782_2006",782,"f","day",150,66,45,37,2,68,82,103,47,0.44,0.3,0.246666666666667,0.0133333333333333,0.453333333333333,0.546666666666667,0.686666666666667,0.313333333333333,"2006"
"649","783_2006_roe","roe",1,1,"783_2006",783,"f","night",129,2,67,59,1,3,126,61,68,0.0155038759689922,0.51937984496124,0.457364341085271,0.00775193798449612,0.0232558139534884,0.976744186046512,0.472868217054264,0.527131782945736,"2006"
"650","783_2006_roe","roe",1,1,"783_2006",783,"f","day",93,1,86,5,1,2,91,6,87,0.010752688172043,0.924731182795699,0.0537634408602151,0.010752688172043,0.021505376344086,0.978494623655914,0.0645161290322581,0.935483870967742,"2006"
"651","784_2006_roe","roe",1,1,"784_2006",784,"f","night",124,43,71,9,1,44,80,52,72,0.346774193548387,0.57258064516129,0.0725806451612903,0.00806451612903226,0.354838709677419,0.645161290322581,0.419354838709677,0.580645161290323,"2006"
"652","784_2006_roe","roe",1,1,"784_2006",784,"f","day",118,22,72,23,1,23,95,45,73,0.186440677966102,0.610169491525424,0.194915254237288,0.00847457627118644,0.194915254237288,0.805084745762712,0.38135593220339,0.61864406779661,"2006"
"653","787_2006_roe","roe",1,1,"787_2006",787,"m","night",154,2,132,1,19,21,133,3,151,0.012987012987013,0.857142857142857,0.00649350649350649,0.123376623376623,0.136363636363636,0.863636363636364,0.0194805194805195,0.980519480519481,"2006"
"654","787_2006_roe","roe",1,1,"787_2006",787,"m","day",127,2,119,3,3,5,122,5,122,0.015748031496063,0.937007874015748,0.0236220472440945,0.0236220472440945,0.0393700787401575,0.960629921259842,0.0393700787401575,0.960629921259842,"2006"
"655","789_2007_roe","roe",1,1,"789_2007",789,"f","night",162,60,26,57,19,79,83,117,45,0.37037037037037,0.160493827160494,0.351851851851852,0.117283950617284,0.487654320987654,0.512345679012346,0.722222222222222,0.277777777777778,"2007"
"656","789_2007_roe","roe",1,1,"789_2007",789,"f","day",145,12,98,10,25,37,108,22,123,0.0827586206896552,0.675862068965517,0.0689655172413793,0.172413793103448,0.255172413793103,0.744827586206897,0.151724137931034,0.848275862068966,"2007"
"657","791_2007_roe","roe",1,1,"791_2007",791,"m","night",179,139,19,16,5,144,35,155,24,0.776536312849162,0.106145251396648,0.0893854748603352,0.0279329608938547,0.804469273743017,0.195530726256983,0.865921787709497,0.134078212290503,"2007"
"658","791_2007_roe","roe",1,1,"791_2007",791,"m","day",159,6,144,6,3,9,150,12,147,0.0377358490566038,0.905660377358491,0.0377358490566038,0.0188679245283019,0.0566037735849057,0.943396226415094,0.0754716981132075,0.924528301886792,"2007"
"659","792_2006_roe","roe",1,1,"792_2006",792,"f","night",166,73,6,86,1,74,92,159,7,0.439759036144578,0.036144578313253,0.518072289156627,0.00602409638554217,0.44578313253012,0.55421686746988,0.957831325301205,0.0421686746987952,"2006"
"660","792_2006_roe","roe",1,1,"792_2006",792,"f","day",146,22,64,59,1,23,123,81,65,0.150684931506849,0.438356164383562,0.404109589041096,0.00684931506849315,0.157534246575342,0.842465753424658,0.554794520547945,0.445205479452055,"2006"
"661","792_2007_roe","roe",1,1,"792_2007",792,"f","night",167,72,16,79,0,72,95,151,16,0.431137724550898,0.0958083832335329,0.473053892215569,0,0.431137724550898,0.568862275449102,0.904191616766467,0.0958083832335329,"2007"
"662","792_2007_roe","roe",1,1,"792_2007",792,"f","day",144,13,48,79,4,17,127,92,52,0.0902777777777778,0.333333333333333,0.548611111111111,0.0277777777777778,0.118055555555556,0.881944444444444,0.638888888888889,0.361111111111111,"2007"
"663","796_2005_roe","roe",1,1,"796_2005",796,"f","night",150,0,146,0,4,4,146,0,150,0,0.973333333333333,0,0.0266666666666667,0.0266666666666667,0.973333333333333,0,1,"2005"
"664","796_2005_roe","roe",1,1,"796_2005",796,"f","day",114,0,112,0,2,2,112,0,114,0,0.982456140350877,0,0.0175438596491228,0.0175438596491228,0.982456140350877,0,1,"2005"
"665","797_2005_roe","roe",1,1,"797_2005",797,"f","night",156,13,134,3,6,19,137,16,140,0.0833333333333333,0.858974358974359,0.0192307692307692,0.0384615384615385,0.121794871794872,0.878205128205128,0.102564102564103,0.897435897435897,"2005"
"666","797_2005_roe","roe",1,1,"797_2005",797,"f","day",145,2,139,1,3,5,140,3,142,0.0137931034482759,0.958620689655172,0.00689655172413793,0.0206896551724138,0.0344827586206897,0.96551724137931,0.0206896551724138,0.979310344827586,"2005"
"667","799_2005_roe","roe",1,1,"799_2005",799,"f","night",132,3,119,4,6,9,123,7,125,0.0227272727272727,0.901515151515151,0.0303030303030303,0.0454545454545455,0.0681818181818182,0.931818181818182,0.053030303030303,0.946969696969697,"2005"
"668","799_2005_roe","roe",1,1,"799_2005",799,"f","day",105,2,99,0,4,6,99,2,103,0.019047619047619,0.942857142857143,0,0.0380952380952381,0.0571428571428571,0.942857142857143,0.019047619047619,0.980952380952381,"2005"
"669","801_2005_roe","roe",1,1,"801_2005",801,"f","night",170,87,15,64,4,91,79,151,19,0.511764705882353,0.0882352941176471,0.376470588235294,0.0235294117647059,0.535294117647059,0.464705882352941,0.888235294117647,0.111764705882353,"2005"
"670","801_2005_roe","roe",1,1,"801_2005",801,"f","day",116,9,44,62,1,10,106,71,45,0.0775862068965517,0.379310344827586,0.53448275862069,0.00862068965517241,0.0862068965517241,0.913793103448276,0.612068965517241,0.387931034482759,"2005"
"671","113_2011_red","red",3,3,"113_2011",113,"m","night",168,62,52,22,32,94,74,84,84,0.369047619047619,0.30952380952381,0.130952380952381,0.19047619047619,0.55952380952381,0.44047619047619,0.5,0.5,"2011"
"672","113_2011_red","red",3,3,"113_2011",113,"m","day",166,13,113,2,38,51,115,15,151,0.0783132530120482,0.680722891566265,0.0120481927710843,0.228915662650602,0.307228915662651,0.692771084337349,0.0903614457831325,0.909638554216867,"2011"
"675","117_2011_red","red",3,3,"117_2011",117,"f","night",174,98,36,14,26,124,50,112,62,0.563218390804598,0.206896551724138,0.0804597701149425,0.149425287356322,0.71264367816092,0.28735632183908,0.64367816091954,0.35632183908046,"2011"
"676","117_2011_red","red",3,3,"117_2011",117,"f","day",174,156,5,13,0,156,18,169,5,0.896551724137931,0.028735632183908,0.0747126436781609,0,0.896551724137931,0.103448275862069,0.971264367816092,0.028735632183908,"2011"
"677","119_2006_red","red",3,3,"119_2006",119,"f","night",143,50,36,47,10,60,83,97,46,0.34965034965035,0.251748251748252,0.328671328671329,0.0699300699300699,0.41958041958042,0.58041958041958,0.678321678321678,0.321678321678322,"2006"
"678","119_2006_red","red",3,3,"119_2006",119,"f","day",109,3,99,1,6,9,100,4,105,0.0275229357798165,0.908256880733945,0.00917431192660551,0.055045871559633,0.0825688073394495,0.917431192660551,0.036697247706422,0.963302752293578,"2006"
"679","120_2005_red","red",3,3,"120_2005",120,"f","night",170,90,42,23,15,105,65,113,57,0.529411764705882,0.247058823529412,0.135294117647059,0.0882352941176471,0.617647058823529,0.382352941176471,0.664705882352941,0.335294117647059,"2005"
"680","120_2005_red","red",3,3,"120_2005",120,"f","day",146,33,96,14,3,36,110,47,99,0.226027397260274,0.657534246575342,0.0958904109589041,0.0205479452054795,0.246575342465753,0.753424657534247,0.321917808219178,0.678082191780822,"2005"
"681","120_2006_red","red",3,3,"120_2006",120,"f","night",170,110,31,24,5,115,55,134,36,0.647058823529412,0.182352941176471,0.141176470588235,0.0294117647058824,0.676470588235294,0.323529411764706,0.788235294117647,0.211764705882353,"2006"
"682","120_2006_red","red",3,3,"120_2006",120,"f","day",161,30,115,12,4,34,127,42,119,0.186335403726708,0.714285714285714,0.0745341614906832,0.0248447204968944,0.211180124223602,0.788819875776398,0.260869565217391,0.739130434782609,"2006"
"683","122_2011_red","red",3,3,"122_2011",122,"f","night",158,27,41,2,88,115,43,29,129,0.170886075949367,0.259493670886076,0.0126582278481013,0.556962025316456,0.727848101265823,0.272151898734177,0.183544303797468,0.816455696202532,"2011"
"684","122_2011_red","red",3,3,"122_2011",122,"f","day",161,7,120,21,13,20,141,28,133,0.0434782608695652,0.745341614906832,0.130434782608696,0.0807453416149068,0.124223602484472,0.875776397515528,0.173913043478261,0.826086956521739,"2011"
"685","127_2008_red","red",3,3,"127_2008",127,"m","night",175,126,7,40,2,128,47,166,9,0.72,0.04,0.228571428571429,0.0114285714285714,0.731428571428571,0.268571428571429,0.948571428571429,0.0514285714285714,"2008"
"686","127_2008_red","red",3,3,"127_2008",127,"m","day",169,5,83,78,3,8,161,83,86,0.029585798816568,0.49112426035503,0.461538461538462,0.0177514792899408,0.0473372781065089,0.952662721893491,0.49112426035503,0.50887573964497,"2008"
"689","137_2010_red","red",3,3,"137_2010",137,"f","night",179,76,42,32,29,105,74,108,71,0.424581005586592,0.23463687150838,0.17877094972067,0.162011173184358,0.58659217877095,0.41340782122905,0.603351955307263,0.396648044692737,"2010"
"690","137_2010_red","red",3,3,"137_2010",137,"f","day",175,0,171,0,4,4,171,0,175,0,0.977142857142857,0,0.0228571428571429,0.0228571428571429,0.977142857142857,0,1,"2010"
"691","137_2011_red","red",3,3,"137_2011",137,"f","night",166,94,27,27,18,112,54,121,45,0.566265060240964,0.162650602409639,0.162650602409639,0.108433734939759,0.674698795180723,0.325301204819277,0.728915662650602,0.271084337349398,"2011"
"692","137_2011_red","red",3,3,"137_2011",137,"f","day",158,4,152,0,2,6,152,4,154,0.0253164556962025,0.962025316455696,0,0.0126582278481013,0.0379746835443038,0.962025316455696,0.0253164556962025,0.974683544303797,"2011"
"693","138_2010_red","red",3,3,"138_2010",138,"f","night",174,86,42,34,12,98,76,120,54,0.494252873563218,0.241379310344828,0.195402298850575,0.0689655172413793,0.563218390804598,0.436781609195402,0.689655172413793,0.310344827586207,"2010"
"694","138_2010_red","red",3,3,"138_2010",138,"f","day",161,3,143,13,2,5,156,16,145,0.0186335403726708,0.888198757763975,0.0807453416149068,0.0124223602484472,0.031055900621118,0.968944099378882,0.0993788819875776,0.900621118012422,"2010"
"695","287_2012_red","red",8,8,"287_2012",287,"m","night",185,134,39,11,1,135,50,145,40,0.724324324324324,0.210810810810811,0.0594594594594595,0.00540540540540541,0.72972972972973,0.27027027027027,0.783783783783784,0.216216216216216,"2012"
"696","287_2012_red","red",8,8,"287_2012",287,"m","day",184,51,69,64,0,51,133,115,69,0.277173913043478,0.375,0.347826086956522,0,0.277173913043478,0.722826086956522,0.625,0.375,"2012"
"701","289_2011_red","red",8,8,"289_2011",289,"f","night",179,137,19,21,2,139,40,158,21,0.76536312849162,0.106145251396648,0.11731843575419,0.0111731843575419,0.776536312849162,0.223463687150838,0.88268156424581,0.11731843575419,"2011"
"702","289_2011_red","red",8,8,"289_2011",289,"f","day",178,27,72,77,2,29,149,104,74,0.151685393258427,0.404494382022472,0.432584269662921,0.0112359550561798,0.162921348314607,0.837078651685393,0.584269662921348,0.415730337078652,"2011"
"705","291_2011_red","red",8,8,"291_2011",291,"f","night",185,176,1,6,2,178,7,182,3,0.951351351351351,0.00540540540540541,0.0324324324324324,0.0108108108108108,0.962162162162162,0.0378378378378378,0.983783783783784,0.0162162162162162,"2011"
"706","291_2011_red","red",8,8,"291_2011",291,"f","day",184,130,3,51,0,130,54,181,3,0.706521739130435,0.016304347826087,0.277173913043478,0,0.706521739130435,0.293478260869565,0.983695652173913,0.016304347826087,"2011"
"715","295_2011_red","red",8,8,"295_2011",295,"f","night",185,100,65,9,11,111,74,109,76,0.540540540540541,0.351351351351351,0.0486486486486487,0.0594594594594595,0.6,0.4,0.589189189189189,0.410810810810811,"2011"
"716","295_2011_red","red",8,8,"295_2011",295,"f","day",184,28,137,14,5,33,151,42,142,0.152173913043478,0.744565217391304,0.0760869565217391,0.0271739130434783,0.179347826086957,0.820652173913043,0.228260869565217,0.771739130434783,"2011"
"723","300_2011_red","red",8,8,"300_2011",300,"f","night",174,78,77,8,11,89,85,86,88,0.448275862068966,0.442528735632184,0.0459770114942529,0.0632183908045977,0.511494252873563,0.488505747126437,0.494252873563218,0.505747126436782,"2011"
"724","300_2011_red","red",8,8,"300_2011",300,"f","day",165,16,140,7,2,18,147,23,142,0.096969696969697,0.848484848484849,0.0424242424242424,0.0121212121212121,0.109090909090909,0.890909090909091,0.139393939393939,0.860606060606061,"2011"
"727","306_2011_red","red",8,8,"306_2011",306,"f","night",185,0,103,0,82,82,103,0,185,0,0.556756756756757,0,0.443243243243243,0.443243243243243,0.556756756756757,0,1,"2011"
"728","306_2011_red","red",8,8,"306_2011",306,"f","day",184,10,139,4,31,41,143,14,170,0.0543478260869565,0.755434782608696,0.0217391304347826,0.168478260869565,0.222826086956522,0.777173913043478,0.0760869565217391,0.923913043478261,"2011"
"733","310_2011_red","red",8,8,"310_2011",310,"f","night",185,139,23,17,6,145,40,156,29,0.751351351351351,0.124324324324324,0.0918918918918919,0.0324324324324324,0.783783783783784,0.216216216216216,0.843243243243243,0.156756756756757,"2011"
"734","310_2011_red","red",8,8,"310_2011",310,"f","day",180,53,24,102,1,54,126,155,25,0.294444444444444,0.133333333333333,0.566666666666667,0.00555555555555556,0.3,0.7,0.861111111111111,0.138888888888889,"2011"
"741","313_2013_red","red",8,8,"313_2013",313,"f","night",185,6,124,7,48,54,131,13,172,0.0324324324324324,0.67027027027027,0.0378378378378378,0.259459459459459,0.291891891891892,0.708108108108108,0.0702702702702703,0.92972972972973,"2013"
"742","313_2013_red","red",8,8,"313_2013",313,"f","day",184,0,135,24,25,25,159,24,160,0,0.733695652173913,0.130434782608696,0.135869565217391,0.135869565217391,0.864130434782609,0.130434782608696,0.869565217391304,"2013"
"749","315_2011_red","red",8,8,"315_2011",315,"m","night",185,3,156,0,26,29,156,3,182,0.0162162162162162,0.843243243243243,0,0.140540540540541,0.156756756756757,0.843243243243243,0.0162162162162162,0.983783783783784,"2011"
"750","315_2011_red","red",8,8,"315_2011",315,"m","day",184,9,154,3,18,27,157,12,172,0.0489130434782609,0.83695652173913,0.016304347826087,0.0978260869565217,0.146739130434783,0.853260869565217,0.0652173913043478,0.934782608695652,"2011"
"751","344_2013_red","red",8,8,"344_2013",344,"f","night",185,24,107,10,44,68,117,34,151,0.12972972972973,0.578378378378378,0.0540540540540541,0.237837837837838,0.367567567567568,0.632432432432432,0.183783783783784,0.816216216216216,"2013"
"752","344_2013_red","red",8,8,"344_2013",344,"f","day",184,0,147,0,37,37,147,0,184,0,0.798913043478261,0,0.201086956521739,0.201086956521739,0.798913043478261,0,1,"2013"
"753","345_2011_red","red",8,8,"345_2011",345,"f","night",185,67,65,37,16,83,102,104,81,0.362162162162162,0.351351351351351,0.2,0.0864864864864865,0.448648648648649,0.551351351351351,0.562162162162162,0.437837837837838,"2011"
"754","345_2011_red","red",8,8,"345_2011",345,"f","day",182,42,76,52,12,54,128,94,88,0.230769230769231,0.417582417582418,0.285714285714286,0.0659340659340659,0.296703296703297,0.703296703296703,0.516483516483517,0.483516483516484,"2011"
"759","348_2011_red","red",8,8,"348_2011",348,"m","night",185,19,111,11,44,63,122,30,155,0.102702702702703,0.6,0.0594594594594595,0.237837837837838,0.340540540540541,0.659459459459459,0.162162162162162,0.837837837837838,"2011"
"760","348_2011_red","red",8,8,"348_2011",348,"m","day",184,7,120,18,39,46,138,25,159,0.0380434782608696,0.652173913043478,0.0978260869565217,0.21195652173913,0.25,0.75,0.135869565217391,0.864130434782609,"2011"
"763","351_2011_red","red",8,8,"351_2011",351,"f","night",185,0,106,0,79,79,106,0,185,0,0.572972972972973,0,0.427027027027027,0.427027027027027,0.572972972972973,0,1,"2011"
"764","351_2011_red","red",8,8,"351_2011",351,"f","day",184,6,150,0,28,34,150,6,178,0.0326086956521739,0.815217391304348,0,0.152173913043478,0.184782608695652,0.815217391304348,0.0326086956521739,0.967391304347826,"2011"
"779","365_2011_red","red",8,8,"365_2011",365,"f","night",185,72,73,36,4,76,109,108,77,0.389189189189189,0.394594594594595,0.194594594594595,0.0216216216216216,0.410810810810811,0.589189189189189,0.583783783783784,0.416216216216216,"2011"
"780","365_2011_red","red",8,8,"365_2011",365,"f","day",184,4,168,9,3,7,177,13,171,0.0217391304347826,0.91304347826087,0.0489130434782609,0.016304347826087,0.0380434782608696,0.96195652173913,0.0706521739130435,0.929347826086957,"2011"
"793","371_2011_red","red",8,8,"371_2011",371,"f","night",185,135,21,25,4,139,46,160,25,0.72972972972973,0.113513513513514,0.135135135135135,0.0216216216216216,0.751351351351351,0.248648648648649,0.864864864864865,0.135135135135135,"2011"
"794","371_2011_red","red",8,8,"371_2011",371,"f","day",184,72,27,85,0,72,112,157,27,0.391304347826087,0.146739130434783,0.46195652173913,0,0.391304347826087,0.608695652173913,0.853260869565217,0.146739130434783,"2011"
"801","376_2011_red","red",8,8,"376_2011",376,"f","night",185,134,30,18,3,137,48,152,33,0.724324324324324,0.162162162162162,0.0972972972972973,0.0162162162162162,0.740540540540541,0.259459459459459,0.821621621621622,0.178378378378378,"2011"
"802","376_2011_red","red",8,8,"376_2011",376,"f","day",184,85,30,65,4,89,95,150,34,0.46195652173913,0.16304347826087,0.353260869565217,0.0217391304347826,0.483695652173913,0.516304347826087,0.815217391304348,0.184782608695652,"2011"
"803","376_2012_red","red",8,8,"376_2012",376,"f","night",185,134,32,17,2,136,49,151,34,0.724324324324324,0.172972972972973,0.0918918918918919,0.0108108108108108,0.735135135135135,0.264864864864865,0.816216216216216,0.183783783783784,"2012"
"804","376_2012_red","red",8,8,"376_2012",376,"f","day",184,66,48,70,0,66,118,136,48,0.358695652173913,0.260869565217391,0.380434782608696,0,0.358695652173913,0.641304347826087,0.739130434782609,0.260869565217391,"2012"
"817","387_2013_red","red",8,8,"387_2013",387,"f","night",185,127,26,20,12,139,46,147,38,0.686486486486486,0.140540540540541,0.108108108108108,0.0648648648648649,0.751351351351351,0.248648648648649,0.794594594594595,0.205405405405405,"2013"
"818","387_2013_red","red",8,8,"387_2013",387,"f","day",184,23,151,3,7,30,154,26,158,0.125,0.820652173913043,0.016304347826087,0.0380434782608696,0.16304347826087,0.83695652173913,0.141304347826087,0.858695652173913,"2013"
"821","389_2013_red","red",8,8,"389_2013",389,"f","night",185,86,74,9,16,102,83,95,90,0.464864864864865,0.4,0.0486486486486487,0.0864864864864865,0.551351351351351,0.448648648648649,0.513513513513513,0.486486486486487,"2013"
"822","389_2013_red","red",8,8,"389_2013",389,"f","day",172,19,130,19,4,23,149,38,134,0.11046511627907,0.755813953488372,0.11046511627907,0.0232558139534884,0.133720930232558,0.866279069767442,0.22093023255814,0.779069767441861,"2013"
"823","390_2013_red","red",8,8,"390_2013",390,"f","night",172,75,59,15,23,98,74,90,82,0.436046511627907,0.343023255813953,0.0872093023255814,0.133720930232558,0.569767441860465,0.430232558139535,0.523255813953488,0.476744186046512,"2013"
"824","390_2013_red","red",8,8,"390_2013",390,"f","day",172,8,150,10,4,12,160,18,154,0.0465116279069767,0.872093023255814,0.0581395348837209,0.0232558139534884,0.0697674418604651,0.930232558139535,0.104651162790698,0.895348837209302,"2013"
"825","391_2013_red","red",8,8,"391_2013",391,"f","night",185,118,34,19,14,132,53,137,48,0.637837837837838,0.183783783783784,0.102702702702703,0.0756756756756757,0.713513513513514,0.286486486486487,0.740540540540541,0.259459459459459,"2013"
"826","391_2013_red","red",8,8,"391_2013",391,"f","day",184,48,122,6,8,56,128,54,130,0.260869565217391,0.66304347826087,0.0326086956521739,0.0434782608695652,0.304347826086957,0.695652173913043,0.293478260869565,0.706521739130435,"2013"
"827","392_2013_red","red",8,8,"392_2013",392,"f","night",185,36,96,8,45,81,104,44,141,0.194594594594595,0.518918918918919,0.0432432432432432,0.243243243243243,0.437837837837838,0.562162162162162,0.237837837837838,0.762162162162162,"2013"
"828","392_2013_red","red",8,8,"392_2013",392,"f","day",184,36,137,10,1,37,147,46,138,0.195652173913043,0.744565217391304,0.0543478260869565,0.00543478260869565,0.201086956521739,0.798913043478261,0.25,0.75,"2013"
"829","393_2013_red","red",8,8,"393_2013",393,"f","night",185,150,7,26,2,152,33,176,9,0.810810810810811,0.0378378378378378,0.140540540540541,0.0108108108108108,0.821621621621622,0.178378378378378,0.951351351351351,0.0486486486486487,"2013"
"830","393_2013_red","red",8,8,"393_2013",393,"f","day",184,95,16,73,0,95,89,168,16,0.516304347826087,0.0869565217391304,0.396739130434783,0,0.516304347826087,0.483695652173913,0.91304347826087,0.0869565217391304,"2013"
"831","394_2013_red","red",8,8,"394_2013",394,"f","night",185,23,109,7,46,69,116,30,155,0.124324324324324,0.589189189189189,0.0378378378378378,0.248648648648649,0.372972972972973,0.627027027027027,0.162162162162162,0.837837837837838,"2013"
"832","394_2013_red","red",8,8,"394_2013",394,"f","day",184,15,141,2,26,41,143,17,167,0.0815217391304348,0.766304347826087,0.0108695652173913,0.141304347826087,0.222826086956522,0.777173913043478,0.0923913043478261,0.907608695652174,"2013"
"833","395_2013_red","red",8,8,"395_2013",395,"f","night",185,155,12,15,3,158,27,170,15,0.837837837837838,0.0648648648648649,0.0810810810810811,0.0162162162162162,0.854054054054054,0.145945945945946,0.918918918918919,0.0810810810810811,"2013"
"834","395_2013_red","red",8,8,"395_2013",395,"f","day",184,120,13,51,0,120,64,171,13,0.652173913043478,0.0706521739130435,0.277173913043478,0,0.652173913043478,0.347826086956522,0.929347826086957,0.0706521739130435,"2013"
"835","396_2013_red","red",8,8,"396_2013",396,"f","night",184,24,105,26,29,53,131,50,134,0.130434782608696,0.570652173913043,0.141304347826087,0.157608695652174,0.28804347826087,0.71195652173913,0.271739130434783,0.728260869565217,"2013"
"836","396_2013_red","red",8,8,"396_2013",396,"f","day",179,15,85,29,50,65,114,44,135,0.0837988826815642,0.474860335195531,0.162011173184358,0.279329608938547,0.363128491620112,0.636871508379888,0.245810055865922,0.754189944134078,"2013"
"837","397_2013_red","red",8,8,"397_2013",397,"f","night",185,2,155,1,27,29,156,3,182,0.0108108108108108,0.837837837837838,0.00540540540540541,0.145945945945946,0.156756756756757,0.843243243243243,0.0162162162162162,0.983783783783784,"2013"
"838","397_2013_red","red",8,8,"397_2013",397,"f","day",184,3,124,14,43,46,138,17,167,0.016304347826087,0.673913043478261,0.0760869565217391,0.233695652173913,0.25,0.75,0.0923913043478261,0.907608695652174,"2013"
"839","398_2013_red","red",8,8,"398_2013",398,"f","night",178,19,95,30,34,53,125,49,129,0.106741573033708,0.533707865168539,0.168539325842697,0.191011235955056,0.297752808988764,0.702247191011236,0.275280898876405,0.724719101123595,"2013"
"840","398_2013_red","red",8,8,"398_2013",398,"f","day",169,52,51,63,3,55,114,115,54,0.307692307692308,0.301775147928994,0.372781065088757,0.0177514792899408,0.325443786982249,0.674556213017751,0.680473372781065,0.319526627218935,"2013"
"841","399_2013_red","red",8,8,"399_2013",399,"f","night",185,97,39,27,22,119,66,124,61,0.524324324324324,0.210810810810811,0.145945945945946,0.118918918918919,0.643243243243243,0.356756756756757,0.67027027027027,0.32972972972973,"2013"
"842","399_2013_red","red",8,8,"399_2013",399,"f","day",184,100,60,21,3,103,81,121,63,0.543478260869565,0.326086956521739,0.114130434782609,0.016304347826087,0.559782608695652,0.440217391304348,0.657608695652174,0.342391304347826,"2013"
"843","444_2010_red","red",14,14,"444_2010",444,"m","night",165,45,117,2,1,46,119,47,118,0.272727272727273,0.709090909090909,0.0121212121212121,0.00606060606060606,0.278787878787879,0.721212121212121,0.284848484848485,0.715151515151515,"2010"
"844","444_2010_red","red",14,14,"444_2010",444,"m","day",158,0,158,0,0,0,158,0,158,0,1,0,0,0,1,0,1,"2010"
"845","445_2009_red","red",14,14,"445_2009",445,"m","night",177,52,105,10,10,62,115,62,115,0.293785310734463,0.593220338983051,0.0564971751412429,0.0564971751412429,0.350282485875706,0.649717514124294,0.350282485875706,0.649717514124294,"2009"
"846","445_2009_red","red",14,14,"445_2009",445,"m","day",172,0,170,0,2,2,170,0,172,0,0.988372093023256,0,0.0116279069767442,0.0116279069767442,0.988372093023256,0,1,"2009"
"847","445_2010_red","red",14,14,"445_2010",445,"m","night",167,58,83,18,8,66,101,76,91,0.347305389221557,0.497005988023952,0.107784431137725,0.0479041916167665,0.395209580838323,0.604790419161677,0.455089820359281,0.544910179640719,"2010"
"848","445_2010_red","red",14,14,"445_2010",445,"m","day",160,0,160,0,0,0,160,0,160,0,1,0,0,0,1,0,1,"2010"
"849","446_2009_red","red",14,14,"446_2009",446,"f","night",171,43,102,10,16,59,112,53,118,0.251461988304094,0.596491228070175,0.0584795321637427,0.0935672514619883,0.345029239766082,0.654970760233918,0.309941520467836,0.690058479532164,"2009"
"850","446_2009_red","red",14,14,"446_2009",446,"f","day",164,0,164,0,0,0,164,0,164,0,1,0,0,0,1,0,1,"2009"
"851","446_2010_red","red",14,14,"446_2010",446,"f","night",151,43,94,5,9,52,99,48,103,0.28476821192053,0.622516556291391,0.033112582781457,0.0596026490066225,0.344370860927152,0.655629139072848,0.317880794701987,0.682119205298013,"2010"
"852","446_2010_red","red",14,14,"446_2010",446,"f","day",151,0,151,0,0,0,151,0,151,0,1,0,0,0,1,0,1,"2010"
"853","447_2013_red","red",14,14,"447_2013",447,"m","night",180,81,74,10,15,96,84,91,89,0.45,0.411111111111111,0.0555555555555556,0.0833333333333333,0.533333333333333,0.466666666666667,0.505555555555556,0.494444444444444,"2013"
"854","447_2013_red","red",14,14,"447_2013",447,"m","day",176,6,159,7,4,10,166,13,163,0.0340909090909091,0.903409090909091,0.0397727272727273,0.0227272727272727,0.0568181818181818,0.943181818181818,0.0738636363636364,0.926136363636364,"2013"
"855","448_2010_red","red",14,14,"448_2010",448,"f","night",155,34,102,5,14,48,107,39,116,0.219354838709677,0.658064516129032,0.032258064516129,0.0903225806451613,0.309677419354839,0.690322580645161,0.251612903225806,0.748387096774194,"2010"
"856","448_2010_red","red",14,14,"448_2010",448,"f","day",155,0,155,0,0,0,155,0,155,0,1,0,0,0,1,0,1,"2010"
"857","448_2011_red","red",14,14,"448_2011",448,"f","night",172,28,127,5,12,40,132,33,139,0.162790697674419,0.738372093023256,0.0290697674418605,0.0697674418604651,0.232558139534884,0.767441860465116,0.191860465116279,0.808139534883721,"2011"
"858","448_2011_red","red",14,14,"448_2011",448,"f","day",169,0,168,0,1,1,168,0,169,0,0.994082840236686,0,0.00591715976331361,0.00591715976331361,0.994082840236686,0,1,"2011"
"859","449_2009_red","red",14,14,"449_2009",449,"m","night",174,109,17,42,6,115,59,151,23,0.626436781609195,0.0977011494252874,0.241379310344828,0.0344827586206897,0.660919540229885,0.339080459770115,0.867816091954023,0.132183908045977,"2009"
"860","449_2009_red","red",14,14,"449_2009",449,"m","day",171,67,57,45,2,69,102,112,59,0.391812865497076,0.333333333333333,0.263157894736842,0.0116959064327485,0.403508771929825,0.596491228070175,0.654970760233918,0.345029239766082,"2009"
"861","449_2010_red","red",14,14,"449_2010",449,"m","night",166,122,6,25,13,135,31,147,19,0.734939759036145,0.036144578313253,0.150602409638554,0.0783132530120482,0.813253012048193,0.186746987951807,0.885542168674699,0.114457831325301,"2010"
"862","449_2010_red","red",14,14,"449_2010",449,"m","day",165,57,57,48,3,60,105,105,60,0.345454545454545,0.345454545454545,0.290909090909091,0.0181818181818182,0.363636363636364,0.636363636363636,0.636363636363636,0.363636363636364,"2010"
"863","451_2010_red","red",14,14,"451_2010",451,"f","night",166,101,41,19,5,106,60,120,46,0.608433734939759,0.246987951807229,0.114457831325301,0.0301204819277108,0.63855421686747,0.36144578313253,0.72289156626506,0.27710843373494,"2010"
"864","451_2010_red","red",14,14,"451_2010",451,"f","day",143,1,126,14,2,3,140,15,128,0.00699300699300699,0.881118881118881,0.0979020979020979,0.013986013986014,0.020979020979021,0.979020979020979,0.104895104895105,0.895104895104895,"2010"
"865","451_2011_red","red",14,14,"451_2011",451,"f","night",172,111,40,15,6,117,55,126,46,0.645348837209302,0.232558139534884,0.0872093023255814,0.0348837209302326,0.680232558139535,0.319767441860465,0.732558139534884,0.267441860465116,"2011"
"866","451_2011_red","red",14,14,"451_2011",451,"f","day",161,6,147,7,1,7,154,13,148,0.0372670807453416,0.91304347826087,0.0434782608695652,0.0062111801242236,0.0434782608695652,0.956521739130435,0.0807453416149068,0.919254658385093,"2011"
"867","452_2010_red","red",14,14,"452_2010",452,"f","night",162,107,45,4,6,113,49,111,51,0.660493827160494,0.277777777777778,0.0246913580246914,0.037037037037037,0.697530864197531,0.302469135802469,0.685185185185185,0.314814814814815,"2010"
"868","452_2010_red","red",14,14,"452_2010",452,"f","day",156,67,84,1,4,71,85,68,88,0.429487179487179,0.538461538461538,0.00641025641025641,0.0256410256410256,0.455128205128205,0.544871794871795,0.435897435897436,0.564102564102564,"2010"
"869","456_2009_red","red",14,14,"456_2009",456,"m","night",169,32,103,2,32,64,105,34,135,0.189349112426035,0.609467455621302,0.0118343195266272,0.189349112426035,0.378698224852071,0.621301775147929,0.201183431952663,0.798816568047337,"2009"
"870","456_2009_red","red",14,14,"456_2009",456,"m","day",170,0,169,1,0,0,170,1,169,0,0.994117647058824,0.00588235294117647,0,0,1,0.00588235294117647,0.994117647058824,"2009"
"871","458_2008_red","red",14,14,"458_2008",458,"m","night",139,85,2,52,0,85,54,137,2,0.611510791366906,0.0143884892086331,0.37410071942446,0,0.611510791366906,0.388489208633094,0.985611510791367,0.0143884892086331,"2008"
"872","458_2008_red","red",14,14,"458_2008",458,"m","day",159,63,8,88,0,63,96,151,8,0.39622641509434,0.050314465408805,0.553459119496855,0,0.39622641509434,0.60377358490566,0.949685534591195,0.050314465408805,"2008"
"873","458_2009_red","red",14,14,"458_2009",458,"m","night",169,102,12,49,6,108,61,151,18,0.603550295857988,0.0710059171597633,0.289940828402367,0.0355029585798817,0.63905325443787,0.36094674556213,0.893491124260355,0.106508875739645,"2009"
"874","458_2009_red","red",14,14,"458_2009",458,"m","day",162,67,32,62,1,68,94,129,33,0.41358024691358,0.197530864197531,0.382716049382716,0.00617283950617284,0.419753086419753,0.580246913580247,0.796296296296296,0.203703703703704,"2009"
"875","458_2010_red","red",14,14,"458_2010",458,"m","night",135,93,1,41,0,93,42,134,1,0.688888888888889,0.00740740740740741,0.303703703703704,0,0.688888888888889,0.311111111111111,0.992592592592593,0.00740740740740741,"2010"
"876","458_2010_red","red",14,14,"458_2010",458,"m","day",140,70,4,66,0,70,70,136,4,0.5,0.0285714285714286,0.471428571428571,0,0.5,0.5,0.971428571428571,0.0285714285714286,"2010"
"877","458_2011_red","red",14,14,"458_2011",458,"m","night",156,103,1,52,0,103,53,155,1,0.66025641025641,0.00641025641025641,0.333333333333333,0,0.66025641025641,0.33974358974359,0.993589743589744,0.00641025641025641,"2011"
"878","458_2011_red","red",14,14,"458_2011",458,"m","day",159,73,5,81,0,73,86,154,5,0.459119496855346,0.0314465408805031,0.509433962264151,0,0.459119496855346,0.540880503144654,0.968553459119497,0.0314465408805031,"2011"
"879","459_2010_red","red",14,14,"459_2010",459,"f","night",150,56,48,32,14,70,80,88,62,0.373333333333333,0.32,0.213333333333333,0.0933333333333333,0.466666666666667,0.533333333333333,0.586666666666667,0.413333333333333,"2010"
"880","459_2010_red","red",14,14,"459_2010",459,"f","day",146,5,112,27,2,7,139,32,114,0.0342465753424658,0.767123287671233,0.184931506849315,0.0136986301369863,0.0479452054794521,0.952054794520548,0.219178082191781,0.780821917808219,"2010"
"881","459_2011_red","red",14,14,"459_2011",459,"f","night",175,24,85,38,28,52,123,62,113,0.137142857142857,0.485714285714286,0.217142857142857,0.16,0.297142857142857,0.702857142857143,0.354285714285714,0.645714285714286,"2011"
"882","459_2011_red","red",14,14,"459_2011",459,"f","day",176,0,169,7,0,0,176,7,169,0,0.960227272727273,0.0397727272727273,0,0,1,0.0397727272727273,0.960227272727273,"2011"
"883","459_2012_red","red",14,14,"459_2012",459,"f","night",117,33,63,12,9,42,75,45,72,0.282051282051282,0.538461538461538,0.102564102564103,0.0769230769230769,0.358974358974359,0.641025641025641,0.384615384615385,0.615384615384615,"2012"
"884","459_2012_red","red",14,14,"459_2012",459,"f","day",121,0,118,3,0,0,121,3,118,0,0.975206611570248,0.0247933884297521,0,0,1,0.0247933884297521,0.975206611570248,"2012"
"885","460_2010_red","red",14,14,"460_2010",460,"m","night",163,129,7,26,1,130,33,155,8,0.791411042944785,0.0429447852760736,0.159509202453988,0.00613496932515337,0.797546012269939,0.202453987730061,0.950920245398773,0.049079754601227,"2010"
"886","460_2010_red","red",14,14,"460_2010",460,"m","day",163,28,13,122,0,28,135,150,13,0.171779141104294,0.0797546012269939,0.748466257668712,0,0.171779141104294,0.828220858895706,0.920245398773006,0.0797546012269939,"2010"
"887","460_2011_red","red",14,14,"460_2011",460,"m","night",143,118,13,11,1,119,24,129,14,0.825174825174825,0.0909090909090909,0.0769230769230769,0.00699300699300699,0.832167832167832,0.167832167832168,0.902097902097902,0.0979020979020979,"2011"
"888","460_2011_red","red",14,14,"460_2011",460,"m","day",143,7,80,56,0,7,136,63,80,0.048951048951049,0.559440559440559,0.391608391608392,0,0.048951048951049,0.951048951048951,0.440559440559441,0.559440559440559,"2011"
"889","461_2010_red","red",14,14,"461_2010",461,"f","night",168,99,50,8,11,110,58,107,61,0.589285714285714,0.297619047619048,0.0476190476190476,0.0654761904761905,0.654761904761905,0.345238095238095,0.636904761904762,0.363095238095238,"2010"
"890","461_2010_red","red",14,14,"461_2010",461,"f","day",164,46,99,1,18,64,100,47,117,0.280487804878049,0.603658536585366,0.00609756097560976,0.109756097560976,0.390243902439024,0.609756097560976,0.286585365853659,0.713414634146341,"2010"
"891","461_2011_red","red",14,14,"461_2011",461,"f","night",179,122,44,6,7,129,50,128,51,0.681564245810056,0.245810055865922,0.0335195530726257,0.0391061452513966,0.720670391061452,0.279329608938547,0.715083798882682,0.284916201117318,"2011"
"892","461_2011_red","red",14,14,"461_2011",461,"f","day",176,66,81,2,27,93,83,68,108,0.375,0.460227272727273,0.0113636363636364,0.153409090909091,0.528409090909091,0.471590909090909,0.386363636363636,0.613636363636364,"2011"
"893","462_2010_red","red",14,14,"462_2010",462,"f","night",163,142,14,2,5,147,16,144,19,0.871165644171779,0.0858895705521472,0.0122699386503067,0.0306748466257669,0.901840490797546,0.098159509202454,0.883435582822086,0.116564417177914,"2010"
"894","462_2010_red","red",14,14,"462_2010",462,"f","day",165,61,79,2,23,84,81,63,102,0.36969696969697,0.478787878787879,0.0121212121212121,0.139393939393939,0.509090909090909,0.490909090909091,0.381818181818182,0.618181818181818,"2010"
"895","463_2010_red","red",14,14,"463_2010",463,"m","night",161,120,15,20,6,126,35,140,21,0.745341614906832,0.093167701863354,0.124223602484472,0.0372670807453416,0.782608695652174,0.217391304347826,0.869565217391304,0.130434782608696,"2010"
"896","463_2010_red","red",14,14,"463_2010",463,"m","day",151,2,101,46,2,4,147,48,103,0.0132450331125828,0.66887417218543,0.304635761589404,0.0132450331125828,0.0264900662251656,0.973509933774834,0.317880794701987,0.682119205298013,"2010"
"899","465_2010_red","red",14,14,"465_2010",465,"m","night",120,57,50,5,8,65,55,62,58,0.475,0.416666666666667,0.0416666666666667,0.0666666666666667,0.541666666666667,0.458333333333333,0.516666666666667,0.483333333333333,"2010"
"900","465_2010_red","red",14,14,"465_2010",465,"m","day",106,10,82,10,4,14,92,20,86,0.0943396226415094,0.773584905660377,0.0943396226415094,0.0377358490566038,0.132075471698113,0.867924528301887,0.188679245283019,0.811320754716981,"2010"
"901","466_2013_red","red",14,14,"466_2013",466,"m","night",182,108,41,17,16,124,58,125,57,0.593406593406593,0.225274725274725,0.0934065934065934,0.0879120879120879,0.681318681318681,0.318681318681319,0.686813186813187,0.313186813186813,"2013"
"902","466_2013_red","red",14,14,"466_2013",466,"m","day",177,34,121,8,14,48,129,42,135,0.192090395480226,0.68361581920904,0.0451977401129944,0.0790960451977401,0.271186440677966,0.728813559322034,0.23728813559322,0.76271186440678,"2013"
"903","702_2005_red","red",21,21,"702_2005",702,"f","night",168,6,95,52,15,21,147,58,110,0.0357142857142857,0.56547619047619,0.30952380952381,0.0892857142857143,0.125,0.875,0.345238095238095,0.654761904761905,"2005"
"904","702_2005_red","red",21,21,"702_2005",702,"f","day",180,3,48,129,0,3,177,132,48,0.0166666666666667,0.266666666666667,0.716666666666667,0,0.0166666666666667,0.983333333333333,0.733333333333333,0.266666666666667,"2005"
"905","702_2006_red","red",21,21,"702_2006",702,"f","night",116,4,71,36,5,9,107,40,76,0.0344827586206897,0.612068965517241,0.310344827586207,0.0431034482758621,0.0775862068965517,0.922413793103448,0.344827586206897,0.655172413793103,"2006"
"906","702_2006_red","red",21,21,"702_2006",702,"f","day",100,1,23,76,0,1,99,77,23,0.01,0.23,0.76,0,0.01,0.99,0.77,0.23,"2006"
"907","703_2009_red","red",21,21,"703_2009",703,"f","night",183,100,64,18,1,101,82,118,65,0.546448087431694,0.349726775956284,0.0983606557377049,0.00546448087431694,0.551912568306011,0.448087431693989,0.644808743169399,0.355191256830601,"2009"
"908","703_2009_red","red",21,21,"703_2009",703,"f","day",181,0,179,2,0,0,181,2,179,0,0.988950276243094,0.0110497237569061,0,0,1,0.0110497237569061,0.988950276243094,"2009"
"909","703_2010_red","red",21,21,"703_2010",703,"f","night",184,120,31,33,0,120,64,153,31,0.652173913043478,0.168478260869565,0.179347826086957,0,0.652173913043478,0.347826086956522,0.831521739130435,0.168478260869565,"2010"
"910","703_2010_red","red",21,21,"703_2010",703,"f","day",182,0,180,0,2,2,180,0,182,0,0.989010989010989,0,0.010989010989011,0.010989010989011,0.989010989010989,0,1,"2010"
"911","706_2010_red","red",21,21,"706_2010",706,"f","night",183,109,59,14,1,110,73,123,60,0.595628415300546,0.322404371584699,0.0765027322404372,0.00546448087431694,0.601092896174863,0.398907103825137,0.672131147540984,0.327868852459016,"2010"
"912","706_2010_red","red",21,21,"706_2010",706,"f","day",183,1,180,2,0,1,182,3,180,0.00546448087431694,0.983606557377049,0.0109289617486339,0,0.00546448087431694,0.994535519125683,0.0163934426229508,0.983606557377049,"2010"
"913","706_2011_red","red",21,21,"706_2011",706,"f","night",184,78,77,26,3,81,103,104,80,0.423913043478261,0.418478260869565,0.141304347826087,0.016304347826087,0.440217391304348,0.559782608695652,0.565217391304348,0.434782608695652,"2011"
"914","706_2011_red","red",21,21,"706_2011",706,"f","day",182,0,182,0,0,0,182,0,182,0,1,0,0,0,1,0,1,"2011"
"915","707_2010_red","red",21,21,"707_2010",707,"m","night",184,13,113,6,52,65,119,19,165,0.0706521739130435,0.614130434782609,0.0326086956521739,0.282608695652174,0.353260869565217,0.646739130434783,0.103260869565217,0.896739130434783,"2010"
"916","707_2010_red","red",21,21,"707_2010",707,"m","day",184,5,170,7,2,7,177,12,172,0.0271739130434783,0.923913043478261,0.0380434782608696,0.0108695652173913,0.0380434782608696,0.96195652173913,0.0652173913043478,0.934782608695652,"2010"
"917","709_2013_red","red",21,21,"709_2013",709,"f","night",178,4,79,1,94,98,80,5,173,0.0224719101123595,0.443820224719101,0.00561797752808989,0.528089887640449,0.550561797752809,0.449438202247191,0.0280898876404494,0.971910112359551,"2013"
"918","709_2013_red","red",21,21,"709_2013",709,"f","day",174,0,121,6,47,47,127,6,168,0,0.695402298850575,0.0344827586206897,0.270114942528736,0.270114942528736,0.729885057471264,0.0344827586206897,0.96551724137931,"2013"
"919","709_2014_red","red",21,21,"709_2014",709,"f","night",185,0,85,2,98,98,87,2,183,0,0.459459459459459,0.0108108108108108,0.52972972972973,0.52972972972973,0.47027027027027,0.0108108108108108,0.989189189189189,"2014"
"920","709_2014_red","red",21,21,"709_2014",709,"f","day",183,0,139,4,40,40,143,4,179,0,0.759562841530055,0.0218579234972678,0.218579234972678,0.218579234972678,0.781420765027322,0.0218579234972678,0.978142076502732,"2014"
"921","710_2009_red","red",21,21,"710_2009",710,"f","night",173,44,113,12,4,48,125,56,117,0.254335260115607,0.653179190751445,0.069364161849711,0.023121387283237,0.277456647398844,0.722543352601156,0.323699421965318,0.676300578034682,"2009"
"922","710_2009_red","red",21,21,"710_2009",710,"f","day",178,2,77,99,0,2,176,101,77,0.0112359550561798,0.432584269662921,0.556179775280899,0,0.0112359550561798,0.98876404494382,0.567415730337079,0.432584269662921,"2009"
"923","710_2010_red","red",21,21,"710_2010",710,"f","night",164,27,114,14,9,36,128,41,123,0.164634146341463,0.695121951219512,0.0853658536585366,0.0548780487804878,0.219512195121951,0.780487804878049,0.25,0.75,"2010"
"924","710_2010_red","red",21,21,"710_2010",710,"f","day",162,1,91,70,0,1,161,71,91,0.00617283950617284,0.561728395061728,0.432098765432099,0,0.00617283950617284,0.993827160493827,0.438271604938272,0.561728395061728,"2010"
"925","710_2011_red","red",21,21,"710_2011",710,"f","night",175,21,130,16,8,29,146,37,138,0.12,0.742857142857143,0.0914285714285714,0.0457142857142857,0.165714285714286,0.834285714285714,0.211428571428571,0.788571428571429,"2011"
"926","710_2011_red","red",21,21,"710_2011",710,"f","day",176,2,82,92,0,2,174,94,82,0.0113636363636364,0.465909090909091,0.522727272727273,0,0.0113636363636364,0.988636363636364,0.534090909090909,0.465909090909091,"2011"
"927","711_2001_red","red",21,21,"711_2001",711,"f","night",149,36,68,28,17,53,96,64,85,0.241610738255034,0.456375838926175,0.187919463087248,0.114093959731544,0.355704697986577,0.644295302013423,0.429530201342282,0.570469798657718,"2001"
"928","711_2001_red","red",21,21,"711_2001",711,"f","day",111,0,102,2,7,7,104,2,109,0,0.918918918918919,0.018018018018018,0.0630630630630631,0.0630630630630631,0.936936936936937,0.018018018018018,0.981981981981982,"2001"
"929","711_2010_red","red",21,21,"711_2010",711,"f","night",183,7,112,7,57,64,119,14,169,0.0382513661202186,0.612021857923497,0.0382513661202186,0.311475409836066,0.349726775956284,0.650273224043716,0.0765027322404372,0.923497267759563,"2010"
"930","711_2010_red","red",21,21,"711_2010",711,"f","day",183,0,171,4,8,8,175,4,179,0,0.934426229508197,0.0218579234972678,0.0437158469945355,0.0437158469945355,0.956284153005464,0.0218579234972678,0.978142076502732,"2010"
"931","712_2014_red","red",21,21,"712_2014",712,"f","night",179,87,71,10,11,98,81,97,82,0.486033519553073,0.396648044692737,0.0558659217877095,0.0614525139664804,0.547486033519553,0.452513966480447,0.541899441340782,0.458100558659218,"2014"
"932","712_2014_red","red",21,21,"712_2014",712,"f","day",176,1,161,9,5,6,170,10,166,0.00568181818181818,0.914772727272727,0.0511363636363636,0.0284090909090909,0.0340909090909091,0.965909090909091,0.0568181818181818,0.943181818181818,"2014"
"933","713_2005_red","red",21,21,"713_2005",713,"f","night",106,26,68,9,3,29,77,35,71,0.245283018867925,0.641509433962264,0.0849056603773585,0.0283018867924528,0.273584905660377,0.726415094339623,0.330188679245283,0.669811320754717,"2005"
"934","713_2005_red","red",21,21,"713_2005",713,"f","day",99,0,85,12,2,2,97,12,87,0,0.858585858585859,0.121212121212121,0.0202020202020202,0.0202020202020202,0.97979797979798,0.121212121212121,0.878787878787879,"2005"
"935","714_2010_red","red",21,21,"714_2010",714,"f","night",183,10,142,6,25,35,148,16,167,0.0546448087431694,0.775956284153005,0.0327868852459016,0.136612021857924,0.191256830601093,0.808743169398907,0.087431693989071,0.912568306010929,"2010"
"936","714_2010_red","red",21,21,"714_2010",714,"f","day",184,0,180,4,0,0,184,4,180,0,0.978260869565217,0.0217391304347826,0,0,1,0.0217391304347826,0.978260869565217,"2010"
"937","714_2011_red","red",21,21,"714_2011",714,"f","night",181,6,126,14,35,41,140,20,161,0.0331491712707182,0.696132596685083,0.0773480662983425,0.193370165745856,0.226519337016575,0.773480662983425,0.110497237569061,0.889502762430939,"2011"
"938","714_2011_red","red",21,21,"714_2011",714,"f","day",183,0,183,0,0,0,183,0,183,0,1,0,0,0,1,0,1,"2011"
"939","716_2001_red","red",21,21,"716_2001",716,"m","night",176,16,116,20,24,40,136,36,140,0.0909090909090909,0.659090909090909,0.113636363636364,0.136363636363636,0.227272727272727,0.772727272727273,0.204545454545455,0.795454545454545,"2001"
"940","716_2001_red","red",21,21,"716_2001",716,"m","day",172,1,161,10,0,1,171,11,161,0.00581395348837209,0.936046511627907,0.0581395348837209,0,0.00581395348837209,0.994186046511628,0.063953488372093,0.936046511627907,"2001"
"941","721_2010_red","red",21,21,"721_2010",721,"f","night",183,9,50,1,123,132,51,10,173,0.0491803278688525,0.273224043715847,0.00546448087431694,0.672131147540984,0.721311475409836,0.278688524590164,0.0546448087431694,0.945355191256831,"2010"
"942","721_2010_red","red",21,21,"721_2010",721,"f","day",184,0,178,0,6,6,178,0,184,0,0.967391304347826,0,0.0326086956521739,0.0326086956521739,0.967391304347826,0,1,"2010"
"943","722_2003_red","red",21,21,"722_2003",722,"m","night",163,8,12,143,0,8,155,151,12,0.049079754601227,0.0736196319018405,0.877300613496933,0,0.049079754601227,0.950920245398773,0.926380368098159,0.0736196319018405,"2003"
"944","722_2003_red","red",21,21,"722_2003",722,"m","day",99,0,0,99,0,0,99,99,0,0,0,1,0,0,1,1,0,"2003"
"945","722_2004_red","red",21,21,"722_2004",722,"m","night",121,15,11,90,5,20,101,105,16,0.12396694214876,0.0909090909090909,0.743801652892562,0.0413223140495868,0.165289256198347,0.834710743801653,0.867768595041322,0.132231404958678,"2004"
"946","722_2004_red","red",21,21,"722_2004",722,"m","day",98,0,7,91,0,0,98,91,7,0,0.0714285714285714,0.928571428571429,0,0,1,0.928571428571429,0.0714285714285714,"2004"
"947","724_2013_red","red",17,17,"724_2013",724,"f","night",184,15,128,2,39,54,130,17,167,0.0815217391304348,0.695652173913043,0.0108695652173913,0.21195652173913,0.293478260869565,0.706521739130435,0.0923913043478261,0.907608695652174,"2013"
"948","724_2013_red","red",17,17,"724_2013",724,"f","day",181,3,157,9,12,15,166,12,169,0.0165745856353591,0.867403314917127,0.0497237569060773,0.0662983425414365,0.0828729281767956,0.917127071823204,0.0662983425414365,0.933701657458563,"2013"
"949","724_2014_red","red",17,17,"724_2014",724,"f","night",176,1,108,0,67,68,108,1,175,0.00568181818181818,0.613636363636364,0,0.380681818181818,0.386363636363636,0.613636363636364,0.00568181818181818,0.994318181818182,"2014"
"950","724_2014_red","red",17,17,"724_2014",724,"f","day",175,0,159,0,16,16,159,0,175,0,0.908571428571429,0,0.0914285714285714,0.0914285714285714,0.908571428571429,0,1,"2014"
"951","725_2009_red","red",17,17,"725_2009",725,"f","night",183,31,86,24,42,73,110,55,128,0.169398907103825,0.469945355191257,0.131147540983607,0.229508196721311,0.398907103825137,0.601092896174863,0.300546448087432,0.699453551912568,"2009"
"952","725_2009_red","red",17,17,"725_2009",725,"f","day",181,2,112,65,2,4,177,67,114,0.0110497237569061,0.61878453038674,0.359116022099448,0.0110497237569061,0.0220994475138122,0.977900552486188,0.370165745856354,0.629834254143646,"2009"
"953","725_2010_red","red",17,17,"725_2010",725,"f","night",182,33,87,12,50,83,99,45,137,0.181318681318681,0.478021978021978,0.0659340659340659,0.274725274725275,0.456043956043956,0.543956043956044,0.247252747252747,0.752747252747253,"2010"
"954","725_2010_red","red",17,17,"725_2010",725,"f","day",179,1,120,44,14,15,164,45,134,0.00558659217877095,0.670391061452514,0.245810055865922,0.0782122905027933,0.0837988826815642,0.916201117318436,0.251396648044693,0.748603351955307,"2010"
"955","727_2002_red","red",17,17,"727_2002",727,"f","night",161,6,127,17,11,17,144,23,138,0.0372670807453416,0.788819875776398,0.105590062111801,0.0683229813664596,0.105590062111801,0.894409937888199,0.142857142857143,0.857142857142857,"2002"
"956","727_2002_red","red",17,17,"727_2002",727,"f","day",113,58,37,12,6,64,49,70,43,0.513274336283186,0.327433628318584,0.106194690265487,0.0530973451327434,0.566371681415929,0.433628318584071,0.619469026548673,0.380530973451327,"2002"
"957","730_2013_red","red",17,17,"730_2013",730,"f","night",185,20,93,14,58,78,107,34,151,0.108108108108108,0.502702702702703,0.0756756756756757,0.313513513513514,0.421621621621622,0.578378378378378,0.183783783783784,0.816216216216216,"2013"
"958","730_2013_red","red",17,17,"730_2013",730,"f","day",184,4,164,13,3,7,177,17,167,0.0217391304347826,0.891304347826087,0.0706521739130435,0.016304347826087,0.0380434782608696,0.96195652173913,0.0923913043478261,0.907608695652174,"2013"
"959","734_2005_red","red",21,21,"734_2005",734,"m","night",147,44,25,53,25,69,78,97,50,0.299319727891156,0.170068027210884,0.360544217687075,0.170068027210884,0.469387755102041,0.530612244897959,0.659863945578231,0.340136054421769,"2005"
"960","734_2005_red","red",21,21,"734_2005",734,"m","day",117,17,40,58,2,19,98,75,42,0.145299145299145,0.341880341880342,0.495726495726496,0.0170940170940171,0.162393162393162,0.837606837606838,0.641025641025641,0.358974358974359,"2005"
"961","742_2009_red","red",17,17,"742_2009",742,"m","night",183,32,121,14,16,48,135,46,137,0.174863387978142,0.66120218579235,0.0765027322404372,0.087431693989071,0.262295081967213,0.737704918032787,0.251366120218579,0.748633879781421,"2009"
"962","742_2009_red","red",17,17,"742_2009",742,"m","day",182,2,138,37,5,7,175,39,143,0.010989010989011,0.758241758241758,0.203296703296703,0.0274725274725275,0.0384615384615385,0.961538461538462,0.214285714285714,0.785714285714286,"2009"
"963","742_2010_red","red",17,17,"742_2010",742,"m","night",182,136,14,6,26,162,20,142,40,0.747252747252747,0.0769230769230769,0.032967032967033,0.142857142857143,0.89010989010989,0.10989010989011,0.78021978021978,0.21978021978022,"2010"
"964","742_2010_red","red",17,17,"742_2010",742,"m","day",183,4,170,4,5,9,174,8,175,0.0218579234972678,0.92896174863388,0.0218579234972678,0.0273224043715847,0.0491803278688525,0.950819672131147,0.0437158469945355,0.956284153005464,"2010"
"965","743_2004_red","red",17,17,"743_2004",743,"f","night",142,5,121,7,9,14,128,12,130,0.0352112676056338,0.852112676056338,0.0492957746478873,0.0633802816901408,0.0985915492957746,0.901408450704225,0.0845070422535211,0.915492957746479,"2004"
"966","743_2004_red","red",17,17,"743_2004",743,"f","day",149,6,137,4,2,8,141,10,139,0.0402684563758389,0.919463087248322,0.0268456375838926,0.0134228187919463,0.0536912751677852,0.946308724832215,0.0671140939597315,0.932885906040268,"2004"
"967","744_2009_red","red",17,17,"744_2009",744,"f","night",183,4,54,1,124,128,55,5,178,0.0218579234972678,0.295081967213115,0.00546448087431694,0.677595628415301,0.699453551912568,0.300546448087432,0.0273224043715847,0.972677595628415,"2009"
"968","744_2009_red","red",17,17,"744_2009",744,"f","day",184,0,166,3,15,15,169,3,181,0,0.902173913043478,0.016304347826087,0.0815217391304348,0.0815217391304348,0.918478260869565,0.016304347826087,0.983695652173913,"2009"
"969","744_2010_red","red",17,17,"744_2010",744,"f","night",184,14,57,5,108,122,62,19,165,0.0760869565217391,0.309782608695652,0.0271739130434783,0.58695652173913,0.66304347826087,0.33695652173913,0.103260869565217,0.896739130434783,"2010"
"970","744_2010_red","red",17,17,"744_2010",744,"f","day",182,0,154,9,19,19,163,9,173,0,0.846153846153846,0.0494505494505494,0.104395604395604,0.104395604395604,0.895604395604396,0.0494505494505494,0.950549450549451,"2010"
"971","745_2010_red","red",17,17,"745_2010",745,"m","night",183,21,139,7,16,37,146,28,155,0.114754098360656,0.759562841530055,0.0382513661202186,0.087431693989071,0.202185792349727,0.797814207650273,0.153005464480874,0.846994535519126,"2010"
"972","745_2010_red","red",17,17,"745_2010",745,"m","day",180,3,171,6,0,3,177,9,171,0.0166666666666667,0.95,0.0333333333333333,0,0.0166666666666667,0.983333333333333,0.05,0.95,"2010"
"973","747_2002_red","red",17,17,"747_2002",747,"f","night",132,1,117,0,14,15,117,1,131,0.00757575757575758,0.886363636363636,0,0.106060606060606,0.113636363636364,0.886363636363636,0.00757575757575758,0.992424242424242,"2002"
"974","747_2002_red","red",17,17,"747_2002",747,"f","day",114,0,102,0,12,12,102,0,114,0,0.894736842105263,0,0.105263157894737,0.105263157894737,0.894736842105263,0,1,"2002"
"975","748_2005_red","red",17,17,"748_2005",748,"m","night",141,31,83,18,9,40,101,49,92,0.219858156028369,0.588652482269504,0.127659574468085,0.0638297872340425,0.283687943262411,0.716312056737589,0.347517730496454,0.652482269503546,"2005"
"976","748_2005_red","red",17,17,"748_2005",748,"m","day",98,0,98,0,0,0,98,0,98,0,1,0,0,0,1,0,1,"2005"
"977","752_2002_red","red",17,17,"752_2002",752,"f","night",163,18,126,8,11,29,134,26,137,0.110429447852761,0.773006134969325,0.049079754601227,0.0674846625766871,0.177914110429448,0.822085889570552,0.159509202453988,0.840490797546012,"2002"
"978","752_2002_red","red",17,17,"752_2002",752,"f","day",118,35,73,3,7,42,76,38,80,0.296610169491525,0.61864406779661,0.0254237288135593,0.0593220338983051,0.355932203389831,0.644067796610169,0.322033898305085,0.677966101694915,"2002"
"979","754_2010_red","red",17,17,"754_2010",754,"f","night",184,53,70,39,22,75,109,92,92,0.28804347826087,0.380434782608696,0.21195652173913,0.119565217391304,0.407608695652174,0.592391304347826,0.5,0.5,"2010"
"980","754_2010_red","red",17,17,"754_2010",754,"f","day",182,0,53,113,16,16,166,113,69,0,0.291208791208791,0.620879120879121,0.0879120879120879,0.0879120879120879,0.912087912087912,0.620879120879121,0.379120879120879,"2010"
"981","757_2012_red","red",17,17,"757_2012",757,"f","night",173,7,106,2,58,65,108,9,164,0.0404624277456647,0.61271676300578,0.0115606936416185,0.335260115606936,0.375722543352601,0.624277456647399,0.0520231213872832,0.947976878612717,"2012"
"982","757_2012_red","red",17,17,"757_2012",757,"f","day",172,0,156,3,13,13,159,3,169,0,0.906976744186046,0.0174418604651163,0.0755813953488372,0.0755813953488372,0.924418604651163,0.0174418604651163,0.982558139534884,"2012"
"983","757_2013_red","red",17,17,"757_2013",757,"f","night",185,1,132,0,52,53,132,1,184,0.00540540540540541,0.713513513513514,0,0.281081081081081,0.286486486486487,0.713513513513514,0.00540540540540541,0.994594594594595,"2013"
"984","757_2013_red","red",17,17,"757_2013",757,"f","day",184,0,172,0,12,12,172,0,184,0,0.934782608695652,0,0.0652173913043478,0.0652173913043478,0.934782608695652,0,1,"2013"
"985","758_2009_red","red",17,17,"758_2009",758,"f","night",184,50,84,30,20,70,114,80,104,0.271739130434783,0.456521739130435,0.16304347826087,0.108695652173913,0.380434782608696,0.619565217391304,0.434782608695652,0.565217391304348,"2009"
"986","758_2009_red","red",17,17,"758_2009",758,"f","day",183,7,108,47,21,28,155,54,129,0.0382513661202186,0.590163934426229,0.256830601092896,0.114754098360656,0.153005464480874,0.846994535519126,0.295081967213115,0.704918032786885,"2009"
"987","758_2010_red","red",17,17,"758_2010",758,"f","night",179,53,79,9,38,91,88,62,117,0.29608938547486,0.441340782122905,0.0502793296089385,0.212290502793296,0.508379888268156,0.491620111731844,0.346368715083799,0.653631284916201,"2010"
"988","758_2010_red","red",17,17,"758_2010",758,"f","day",179,6,116,39,18,24,155,45,134,0.0335195530726257,0.64804469273743,0.217877094972067,0.100558659217877,0.134078212290503,0.865921787709497,0.251396648044693,0.748603351955307,"2010"
"989","759_2014_red","red",17,17,"759_2014",759,"f","night",160,106,30,11,13,119,41,117,43,0.6625,0.1875,0.06875,0.08125,0.74375,0.25625,0.73125,0.26875,"2014"
"990","759_2014_red","red",17,17,"759_2014",759,"f","day",158,69,51,32,6,75,83,101,57,0.436708860759494,0.322784810126582,0.20253164556962,0.0379746835443038,0.474683544303797,0.525316455696203,0.639240506329114,0.360759493670886,"2014"
"991","760_2009_red","red",17,17,"760_2009",760,"f","night",184,10,129,19,26,36,148,29,155,0.0543478260869565,0.701086956521739,0.103260869565217,0.141304347826087,0.195652173913043,0.804347826086957,0.157608695652174,0.842391304347826,"2009"
"992","760_2009_red","red",17,17,"760_2009",760,"f","day",183,2,146,24,11,13,170,26,157,0.0109289617486339,0.797814207650273,0.131147540983607,0.0601092896174863,0.0710382513661202,0.92896174863388,0.14207650273224,0.85792349726776,"2009"
"993","760_2010_red","red",17,17,"760_2010",760,"f","night",184,8,142,19,15,23,161,27,157,0.0434782608695652,0.771739130434783,0.103260869565217,0.0815217391304348,0.125,0.875,0.146739130434783,0.853260869565217,"2010"
"994","760_2010_red","red",17,17,"760_2010",760,"f","day",180,6,148,16,10,16,164,22,158,0.0333333333333333,0.822222222222222,0.0888888888888889,0.0555555555555556,0.0888888888888889,0.911111111111111,0.122222222222222,0.877777777777778,"2010"
"995","762_2009_red","red",17,17,"762_2009",762,"f","night",178,2,123,14,39,41,137,16,162,0.0112359550561798,0.691011235955056,0.0786516853932584,0.219101123595506,0.230337078651685,0.769662921348315,0.0898876404494382,0.910112359550562,"2009"
"996","762_2009_red","red",17,17,"762_2009",762,"f","day",176,0,162,12,2,2,174,12,164,0,0.920454545454545,0.0681818181818182,0.0113636363636364,0.0113636363636364,0.988636363636364,0.0681818181818182,0.931818181818182,"2009"
"997","762_2010_red","red",17,17,"762_2010",762,"f","night",184,2,103,2,77,79,105,4,180,0.0108695652173913,0.559782608695652,0.0108695652173913,0.418478260869565,0.429347826086957,0.570652173913043,0.0217391304347826,0.978260869565217,"2010"
"998","762_2010_red","red",17,17,"762_2010",762,"f","day",184,1,164,3,16,17,167,4,180,0.00543478260869565,0.891304347826087,0.016304347826087,0.0869565217391304,0.0923913043478261,0.907608695652174,0.0217391304347826,0.978260869565217,"2010"
"999","763_2014_red","red",17,17,"763_2014",763,"f","night",185,5,95,5,80,85,100,10,175,0.027027027027027,0.513513513513513,0.027027027027027,0.432432432432432,0.459459459459459,0.540540540540541,0.0540540540540541,0.945945945945946,"2014"
"1000","763_2014_red","red",17,17,"763_2014",763,"f","day",184,0,163,1,20,20,164,1,183,0,0.885869565217391,0.00543478260869565,0.108695652173913,0.108695652173913,0.891304347826087,0.00543478260869565,0.994565217391304,"2014"
