"","aniyr_species","species","population","study_areas_id","aniyr","animals_id","area","time","total","clc0tcd0","clc1tcd1","clc0tcd1","clc1tcd0","tcd_open_abs","tcd_forest_abs","clc_open_abs","clc_forest_abs","clc0tcd0_prop","clc1tcd1_prop","clc0tcd1_prop","clc1tcd0_prop","tcd_open_prop","tcd_forest_prop","clc_open_prop","clc_forest_prop","yearx"
"1","769_2005_roe","roe",1,1,"769_2005",769,67.7692708007813,"night",1695,48,1498,76,73,121,1574,124,1571,0.0283185840707965,0.883775811209439,0.0448377581120944,0.0430678466076696,0.0713864306784661,0.928613569321534,0.0731563421828909,0.926843657817109,"2005"
"2","770_2005_roe","roe",1,1,"770_2005",770,54.5487213867188,"night",1365,220,567,493,85,305,1060,713,652,0.161172161172161,0.415384615384615,0.361172161172161,0.0622710622710623,0.223443223443223,0.776556776556777,0.522344322344322,0.477655677655678,"2005"
"3","771_2005_roe","roe",1,1,"771_2005",771,245.202249902344,"night",6128,1365,3682,508,573,1938,4190,1873,4255,0.222748041775457,0.600848563968668,0.0828981723237598,0.0935052219321149,0.316253263707572,0.683746736292428,0.305646214099217,0.694353785900783,"2005"
"4","772_2005_roe","roe",1,1,"772_2005",772,40.1177567382813,"night",1002,646,197,21,138,784,218,667,335,0.644710578842315,0.196606786427146,0.0209580838323353,0.137724550898204,0.782435129740519,0.217564870259481,0.665668662674651,0.334331337325349,"2005"
"5","774_2006_roe","roe",1,1,"774_2006",774,70.5828624023437,"night",1764,909,231,575,49,958,806,1484,280,0.51530612244898,0.130952380952381,0.325963718820862,0.0277777777777778,0.543083900226757,0.456916099773243,0.841269841269841,0.158730158730159,"2006"
"6","774_2007_roe","roe",1,1,"774_2007",774,43.0941685546875,"night",1078,525,122,408,23,548,530,933,145,0.487012987012987,0.11317254174397,0.37847866419295,0.0213358070500928,0.50834879406308,0.49165120593692,0.865491651205937,0.134508348794063,"2007"
"7","776_2006_roe","roe",1,1,"776_2006",776,33.6961107421875,"night",844,157,285,396,6,163,681,553,291,0.186018957345972,0.337677725118483,0.469194312796209,0.00710900473933649,0.193127962085308,0.806872037914692,0.65521327014218,0.34478672985782,"2006"
"8","782_2006_roe","roe",1,1,"782_2006",782,362.104366601563,"night",9044,5676,1673,1180,515,6191,2853,6856,2188,0.627598407784166,0.184984520123839,0.13047324192835,0.0569438301636444,0.684542237947811,0.315457762052189,0.758071649712517,0.241928350287483,"2006"
"9","783_2006_roe","roe",1,1,"783_2006",783,46.98466640625,"night",1176,100,858,210,8,108,1068,310,866,0.0850340136054422,0.729591836734694,0.178571428571429,0.00680272108843537,0.0918367346938776,0.908163265306122,0.263605442176871,0.736394557823129,"2006"
"10","784_2006_roe","roe",1,1,"784_2006",784,97.2086671875,"night",2433,677,1334,385,37,714,1719,1062,1371,0.278257295519934,0.548294286888615,0.158240854911632,0.0152075626798192,0.293464858199753,0.706535141800247,0.436498150431566,0.563501849568434,"2006"
"11","787_2006_roe","roe",1,1,"787_2006",787,83.398384375,"night",2085,374,1174,95,442,816,1269,469,1616,0.179376498800959,0.563069544364508,0.0455635491606715,0.211990407673861,0.39136690647482,0.60863309352518,0.224940047961631,0.775059952038369,"2006"
"12","789_2007_roe","roe",1,1,"789_2007",789,16.2718688476563,"night",403,189,117,57,40,229,174,246,157,0.468982630272953,0.290322580645161,0.141439205955335,0.0992555831265509,0.568238213399504,0.431761786600496,0.610421836228288,0.389578163771712,"2007"
"13","791_2007_roe","roe",1,1,"791_2007",791,100.503302148437,"night",2509,1527,591,372,19,1546,963,1899,610,0.608609007572738,0.235552012754085,0.14826624153049,0.00757273814268633,0.616181745715425,0.383818254284576,0.756875249103228,0.243124750896772,"2007"
"14","792_2006_roe","roe",1,1,"792_2006",792,46.8623891601562,"night",1169,610,132,424,3,613,556,1034,135,0.521813515825492,0.112917023096664,0.362703165098375,0.00256629597946963,0.524379811804962,0.475620188195038,0.884516680923867,0.115483319076133,"2006"
"15","792_2007_roe","roe",1,1,"792_2007",792,60.64384453125,"night",1515,752,254,463,46,798,717,1215,300,0.496369636963696,0.167656765676568,0.305610561056106,0.0303630363036304,0.526732673267327,0.473267326732673,0.801980198019802,0.198019801980198,"2007"
"16","796_2005_roe","roe",1,1,"796_2005",796,25.1872029296875,"night",629,0,597,0,32,32,597,0,629,0,0.94912559618442,0,0.0508744038155803,0.0508744038155803,0.94912559618442,0,1,"2005"
"17","797_2005_roe","roe",1,1,"797_2005",797,204.311086132813,"night",5106,962,3376,652,116,1078,4028,1614,3492,0.188405797101449,0.661182922052487,0.127692910301606,0.0227183705444575,0.211124167645907,0.788875832354093,0.316098707403055,0.683901292596945,"2005"
"18","799_2005_roe","roe",1,1,"799_2005",799,133.271854882813,"night",3343,253,2459,414,217,470,2873,667,2676,0.0756805264732276,0.73556685611726,0.123840861501645,0.0649117559078672,0.140592282381095,0.859407717618905,0.199521387974873,0.800478612025127,"2005"
"19","801_2005_roe","roe",1,1,"801_2005",801,10.3762623046875,"night",259,113,43,94,9,122,137,207,52,0.436293436293436,0.166023166023166,0.362934362934363,0.0347490347490347,0.471042471042471,0.528957528957529,0.799227799227799,0.200772200772201,"2005"
"24","1402_2010_roe","roe",2,2,"1402_2010",1402,43.0028559570313,"night",1077,0,779,0,298,298,779,0,1077,0,0.72330547818013,0,0.27669452181987,0.27669452181987,0.72330547818013,0,1,"2010"
"25","14_2006_roe","roe",2,2,"14_2006",14,25.921662109375,"night",643,0,387,0,256,256,387,0,643,0,0.601866251944012,0,0.398133748055988,0.398133748055988,0.601866251944012,0,1,"2006"
"26","14_2007_roe","roe",2,2,"14_2007",14,29.0077473632813,"night",725,0,474,0,251,251,474,0,725,0,0.653793103448276,0,0.346206896551724,0.346206896551724,0.653793103448276,0,1,"2007"
"27","14_2010_roe","roe",2,2,"14_2010",14,29.0810947265625,"night",726,0,493,0,233,233,493,0,726,0,0.679063360881543,0,0.320936639118457,0.320936639118457,0.679063360881543,0,1,"2010"
"28","1429_2010_roe","roe",2,2,"1429_2010",1429,389.424790820313,"night",9731,79,8907,638,107,186,9545,717,9014,0.00811838454424006,0.915322166272737,0.0655636625218374,0.0109957866611859,0.019114171205426,0.980885828794574,0.0736820470660775,0.926317952933922,"2010"
"33","1956_2010_roe","roe",2,2,"1956_2010",1956,3734.22258955078,"night",93373,26528,49000,15162,2683,29211,64162,41690,51683,0.28410782560269,0.52477696978784,0.162380988080066,0.0287342165294036,0.312842042132094,0.687157957867906,0.446488813682756,0.553511186317244,"2010"
"34","1958_2010_roe","roe",2,2,"1958_2010",1958,152.239397265625,"night",3807,0,3535,0,272,272,3535,0,3807,0,0.928552666141319,0,0.0714473338586814,0.0714473338586814,0.928552666141319,0,1,"2010"
"36","1962_2010_roe","roe",2,2,"1962_2010",1962,6906.49669433594,"night",172670,42371,78076,47581,4642,47013,125657,89952,82718,0.245387154688133,0.452168877048706,0.275560317368391,0.0268836508947704,0.272270805582904,0.727729194417096,0.520947472056524,0.479052527943476,"2010"
"37","1964_2010_roe","roe",2,2,"1964_2010",1964,843.27593203125,"night",21083,3204,16180,994,705,3909,17174,4198,16885,0.151970782146753,0.767442963525115,0.0471469904662524,0.0334392638618792,0.185410046008633,0.814589953991367,0.199117772613006,0.800882227386994,"2010"
"40","1973_2010_roe","roe",2,2,"1973_2010",1973,33.315655859375,"night",832,253,380,120,79,332,500,373,459,0.304086538461538,0.456730769230769,0.144230769230769,0.0949519230769231,0.399038461538462,0.600961538461538,0.448317307692308,0.551682692307692,"2010"
"41","1973_2011_roe","roe",2,2,"1973_2011",1973,91.8432061523438,"night",2293,616,1319,133,225,841,1452,749,1544,0.268643698211949,0.57522895769734,0.0580026166593982,0.0981247274313127,0.366768425643262,0.633231574356738,0.326646314871348,0.673353685128652,"2011"
"44","1982_2010_roe","roe",2,2,"1982_2010",1982,134.130352050781,"night",3358,0,2918,0,440,440,2918,0,3358,0,0.868969624776653,0,0.131030375223347,0.131030375223347,0.868969624776653,0,1,"2010"
"45","1985_2010_roe","roe",2,2,"1985_2010",1985,99.9459858398437,"night",2498,0,2142,0,356,356,2142,0,2498,0,0.857485988791033,0,0.142514011208967,0.142514011208967,0.857485988791033,0,1,"2010"
"48","1991_2010_roe","roe",2,2,"1991_2010",1991,4739.53672001953,"night",118494,61947,41326,13202,2019,63966,54528,75149,43345,0.522785963846271,0.348760274781846,0.111414923962395,0.0170388374094891,0.53982480125576,0.46017519874424,0.634200887808665,0.365799112191335,"2010"
"49","1993_2010_roe","roe",2,2,"1993_2010",1993,31.7965813476563,"night",794,152,577,48,17,169,625,200,594,0.191435768261965,0.726700251889169,0.0604534005037783,0.0214105793450882,0.212846347607053,0.787153652392947,0.251889168765743,0.748110831234257,"2010"
"50","1994_2010_roe","roe",2,2,"1994_2010",1994,135.1655984375,"night",3374,401,2560,396,17,418,2956,797,2577,0.118850029638411,0.758743331357439,0.117368109069354,0.0050385299347955,0.123888559573207,0.876111440426793,0.236218138707765,0.763781861292235,"2010"
"51","1994_2011_roe","roe",2,2,"1994_2011",1994,93.6723051757812,"night",2337,238,1780,299,20,258,2079,537,1800,0.101839965768079,0.761660248181429,0.127941805733847,0.00855798031664527,0.110397946084724,0.889602053915276,0.229781771501926,0.770218228498074,"2011"
"52","1996_2010_roe","roe",2,2,"1996_2010",1996,69.6246805664063,"night",1748,564,751,177,256,820,928,741,1007,0.322654462242563,0.429633867276888,0.101258581235698,0.146453089244851,0.469107551487414,0.530892448512586,0.423913043478261,0.576086956521739,"2010"
"53","2000_2010_roe","roe",2,2,"2000_2010",2000,41.9542060546875,"night",1052,628,384,38,2,630,422,666,386,0.596958174904943,0.365019011406844,0.0361216730038023,0.00190114068441065,0.598859315589354,0.401140684410646,0.633079847908745,0.366920152091255,"2010"
"55","2008_2010_roe","roe",2,2,"2008_2010",2008,38.5615442382813,"night",963,0,658,0,305,305,658,0,963,0,0.683281412253375,0,0.316718587746625,0.316718587746625,0.683281412253375,0,1,"2010"
"56","2008_2011_roe","roe",2,2,"2008_2011",2008,41.10236875,"night",1029,0,709,0,320,320,709,0,1029,0,0.689018464528669,0,0.310981535471331,0.310981535471331,0.689018464528669,0,1,"2011"
"57","2011_2010_roe","roe",2,2,"2011_2010",2011,122.446381445312,"night",3065,1301,1611,72,81,1382,1683,1373,1692,0.424469820554649,0.525611745513866,0.0234910277324633,0.0264274061990212,0.45089722675367,0.54910277324633,0.447960848287113,0.552039151712887,"2010"
"58","2013_2010_roe","roe",2,2,"2013_2010",2013,30.0904041015625,"night",751,189,494,42,26,215,536,231,520,0.251664447403462,0.657789613848202,0.0559254327563249,0.0346205059920107,0.286284953395473,0.713715046604527,0.307589880159787,0.692410119840213,"2010"
"59","2014_2010_roe","roe",2,2,"2014_2010",2014,90.515182421875,"night",2263,1301,864,69,29,1330,933,1370,893,0.574900574458683,0.38179407865665,0.0304904993371631,0.0128148475475033,0.587715422006186,0.412284577993814,0.605391073795846,0.394608926204154,"2010"
"60","2014_2011_roe","roe",2,2,"2014_2011",2014,90.9777426757812,"night",2273,1734,457,77,5,1739,534,1811,462,0.762868455785306,0.201055873295205,0.0338759348878135,0.0021997360316762,0.765068191816982,0.234931808183018,0.796744390673119,0.203255609326881,"2011"
"64","2030_2010_roe","roe",2,2,"2030_2010",2030,79.5764497070312,"night",1987,1478,448,54,7,1485,502,1532,455,0.743834927025667,0.22546552591847,0.027176648213387,0.00352289884247609,0.747357825868143,0.252642174131857,0.771011575239054,0.228988424760946,"2010"
"66","21_2010_roe","roe",2,2,"21_2010",21,108.130294238281,"night",2706,0,2348,0,358,358,2348,0,2706,0,0.86770140428677,0,0.13229859571323,0.13229859571323,0.86770140428677,0,1,"2010"
"87","1728_2006_roe","roe",8,8,"1728_2006",1728,24.3551777832031,"night",606,295,0,311,0,295,311,606,0,0.486798679867987,0,0.513201320132013,0,0.486798679867987,0.513201320132013,1,0,"2006"
"88","1728_2011_roe","roe",8,8,"1728_2011",1728,35.7858814941406,"night",895,455,0,440,0,455,440,895,0,0.508379888268156,0,0.491620111731844,0,0.508379888268156,0.491620111731844,1,0,"2011"
"127","1777_2008_roe","roe",8,8,"1777_2008",1777,571.566996240234,"night",14292,13524,0,768,0,13524,768,14292,0,0.946263643996641,0,0.0537363560033585,0,0.946263643996641,0.0537363560033585,1,0,"2008"
"128","1777_2011_roe","roe",8,8,"1777_2011",1777,108.419908105469,"night",2713,2649,31,16,17,2666,47,2665,48,0.976409878363435,0.011426465167711,0.00589753040914117,0.0062661260597125,0.982676004423148,0.0173239955768522,0.982307408772576,0.0176925912274235,"2011"
"147","1807_2009_roe","roe",8,8,"1807_2009",1807,550.521532617188,"night",13755,12878,13,864,0,12878,877,13742,13,0.936241366775718,0.000945110868774991,0.0628135223555071,0,0.936241366775718,0.0637586332242821,0.999054889131225,0.000945110868774991,"2009"
"148","1807_2011_roe","roe",8,8,"1807_2011",1807,102.450606640625,"night",2560,2362,17,154,27,2389,171,2516,44,0.92265625,0.006640625,0.06015625,0.010546875,0.933203125,0.066796875,0.9828125,0.0171875,"2011"
"154","1817_2009_roe","roe",8,8,"1817_2009",1817,64.2506157226562,"night",1602,1378,0,224,0,1378,224,1602,0,0.860174781523096,0,0.139825218476904,0,0.860174781523096,0.139825218476904,1,0,"2009"
"155","1817_2011_roe","roe",8,8,"1817_2011",1817,136.477277197266,"night",3410,3125,0,285,0,3125,285,3410,0,0.916422287390029,0,0.0835777126099707,0,0.916422287390029,0.0835777126099707,1,0,"2011"
"161","1827_2011_roe","roe",8,8,"1827_2011",1827,80.0297482910156,"night",1996,1885,0,111,0,1885,111,1996,0,0.94438877755511,0,0.0556112224448898,0,0.94438877755511,0.0556112224448898,1,0,"2011"
"168","1835_2011_roe","roe",8,8,"1835_2011",1835,48.1532349609375,"night",1208,650,482,58,18,668,540,708,500,0.538079470198676,0.399006622516556,0.0480132450331126,0.0149006622516556,0.552980132450331,0.447019867549669,0.586092715231788,0.413907284768212,"2011"
"174","1857_2011_roe","roe",8,8,"1857_2011",1857,74.202159765625,"night",1850,1598,0,251,1,1599,251,1849,1,0.863783783783784,0,0.135675675675676,0.000540540540540541,0.864324324324324,0.135675675675676,0.999459459459459,0.000540540540540541,"2011"
"175","1859_2011_roe","roe",8,8,"1859_2011",1859,76.2501012207031,"night",1904,1296,0,608,0,1296,608,1904,0,0.680672268907563,0,0.319327731092437,0,0.680672268907563,0.319327731092437,1,0,"2011"
"176","1860_2011_roe","roe",8,8,"1860_2011",1860,127.975404199219,"night",3190,2926,0,264,0,2926,264,3190,0,0.917241379310345,0,0.0827586206896552,0,0.917241379310345,0.0827586206896552,1,0,"2011"
"177","1861_2011_roe","roe",8,8,"1861_2011",1861,49.7553233398437,"night",1250,1122,0,128,0,1122,128,1250,0,0.8976,0,0.1024,0,0.8976,0.1024,1,0,"2011"
"178","1865_2011_roe","roe",8,8,"1865_2011",1865,123.080378466797,"night",3076,2671,0,405,0,2671,405,3076,0,0.868335500650195,0,0.131664499349805,0,0.868335500650195,0.131664499349805,1,0,"2011"
"179","1866_2011_roe","roe",8,8,"1866_2011",1866,140.379237841797,"night",3514,3305,0,209,0,3305,209,3514,0,0.940523619806488,0,0.0594763801935117,0,0.940523619806488,0.0594763801935117,1,0,"2011"
"180","1867_2011_roe","roe",8,8,"1867_2011",1867,293.287312255859,"night",7331,5290,284,1672,85,5375,1956,6962,369,0.721593234210885,0.0387395989633065,0.228072568544537,0.0115945982812713,0.733187832492157,0.266812167507843,0.949665802755422,0.0503341972445778,"2011"
"181","1869_2011_roe","roe",8,8,"1869_2011",1869,58.514058203125,"night",1461,1276,116,65,4,1280,181,1341,120,0.87337440109514,0.0793976728268309,0.0444900752908966,0.0027378507871321,0.876112251882272,0.123887748117728,0.917864476386037,0.082135523613963,"2011"
"182","1871_2011_roe","roe",8,8,"1871_2011",1871,27.5409916503906,"night",686,256,394,28,8,264,422,284,402,0.373177842565598,0.574344023323615,0.0408163265306122,0.0116618075801749,0.384839650145773,0.615160349854227,0.41399416909621,0.58600583090379,"2011"
"183","1873_2011_roe","roe",8,8,"1873_2011",1873,86.8627331054687,"night",2169,1158,931,51,29,1187,982,1209,960,0.533886583679115,0.429230059935454,0.0235131396957123,0.0133702166897188,0.547256800368834,0.452743199631166,0.557399723374827,0.442600276625173,"2011"
"184","1874_2011_roe","roe",8,8,"1874_2011",1874,199.224162353516,"night",4983,3181,1522,272,8,3189,1794,3453,1530,0.638370459562513,0.305438490868954,0.0545855910094321,0.00160545855910094,0.639975918121613,0.360024081878387,0.692956050571945,0.307043949428055,"2011"
"185","1875_2011_roe","roe",8,8,"1875_2011",1875,33.3747190917969,"night",837,663,97,41,36,699,138,704,133,0.792114695340502,0.115890083632019,0.0489844683393071,0.043010752688172,0.835125448028674,0.164874551971326,0.841099163679809,0.158900836320191,"2011"
"186","1876_2011_roe","roe",8,8,"1876_2011",1876,68.337694921875,"night",1711,1584,0,115,12,1596,115,1699,12,0.925774400935126,0,0.0672121566335476,0.00701344243132671,0.932787843366452,0.0672121566335476,0.992986557568673,0.00701344243132671,"2011"
"187","1878_2011_roe","roe",8,8,"1878_2011",1878,700.836173388672,"night",17520,13642,1916,1513,449,14091,3429,15155,2365,0.77865296803653,0.109360730593607,0.0863584474885845,0.0256278538812785,0.804280821917808,0.195719178082192,0.865011415525114,0.134988584474886,"2011"
"188","1880_2011_roe","roe",8,8,"1880_2011",1880,143.191515869141,"night",3587,2556,0,1031,0,2556,1031,3587,0,0.71257318093114,0,0.28742681906886,0,0.71257318093114,0.28742681906886,1,0,"2011"
"189","1881_2011_roe","roe",8,8,"1881_2011",1881,32.0674251464844,"night",803,744,0,59,0,744,59,803,0,0.926525529265255,0,0.0734744707347447,0,0.926525529265255,0.0734744707347447,1,0,"2011"
"190","1882_2011_roe","roe",8,8,"1882_2011",1882,26.1161920898438,"night",652,473,108,8,63,536,116,481,171,0.725460122699387,0.165644171779141,0.0122699386503067,0.0966257668711656,0.822085889570552,0.177914110429448,0.737730061349693,0.262269938650307,"2011"
"191","1882_2013_roe","roe",8,8,"1882_2013",1882,36.6377328125,"night",917,575,226,11,105,680,237,586,331,0.627044711014177,0.246455834242094,0.0119956379498364,0.114503816793893,0.74154852780807,0.25845147219193,0.639040348964013,0.360959651035987,"2013"
"192","1883_2011_roe","roe",8,8,"1883_2011",1883,36.6639384277344,"night",916,759,0,157,0,759,157,916,0,0.828602620087336,0,0.171397379912664,0,0.828602620087336,0.171397379912664,1,0,"2011"
"213","1936_2011_roe","roe",8,8,"1936_2011",1936,91.2360757324219,"night",2276,1614,0,662,0,1614,662,2276,0,0.709138840070299,0,0.290861159929701,0,0.709138840070299,0.290861159929701,1,0,"2011"
"214","1937_2010_roe","roe",8,8,"1937_2010",1937,136.685319140625,"night",3414,3282,0,132,0,3282,132,3414,0,0.961335676625659,0,0.0386643233743409,0,0.961335676625659,0.0386643233743409,1,0,"2010"
"215","1937_2011_roe","roe",8,8,"1937_2011",1937,77.3179270019531,"night",1931,1798,0,133,0,1798,133,1931,0,0.931123770067323,0,0.0688762299326774,0,0.931123770067323,0.0688762299326774,1,0,"2011"
"216","1937_2012_roe","roe",8,8,"1937_2012",1937,59.3653803710937,"night",1482,1411,0,71,0,1411,71,1482,0,0.952091767881242,0,0.0479082321187584,0,0.952091767881242,0.0479082321187584,1,0,"2012"
"235","1453_2010_roe","roe",15,15,"1453_2010",1453,21.5429479492187,"night",532,384,124,2,22,406,126,386,146,0.721804511278195,0.233082706766917,0.0037593984962406,0.0413533834586466,0.763157894736842,0.236842105263158,0.725563909774436,0.274436090225564,"2010"
"236","1454_2010_roe","roe",15,15,"1454_2010",1454,17.2866822265625,"night",434,386,8,0,40,426,8,386,48,0.889400921658986,0.0184331797235023,0,0.0921658986175115,0.981566820276498,0.0184331797235023,0.889400921658986,0.110599078341014,"2010"
"237","1455_2010_roe","roe",15,15,"1455_2010",1455,39.3697538085937,"night",982,190,682,2,108,298,684,192,790,0.193482688391039,0.694501018329939,0.00203665987780041,0.109979633401222,0.303462321792261,0.696537678207739,0.195519348268839,0.804480651731161,"2010"
"238","1457_2010_roe","roe",15,15,"1457_2010",1457,16.9463611328125,"night",422,422,0,0,0,422,0,422,0,1,0,0,0,1,0,1,0,"2010"
"239","2041_2011_roe","roe",15,15,"2041_2011",2041,25.6075567382813,"night",643,453,167,6,17,470,173,459,184,0.704510108864697,0.259720062208398,0.00933125972006221,0.0264385692068429,0.73094867807154,0.26905132192846,0.713841368584759,0.286158631415241,"2011"
"240","2043_2011_roe","roe",15,15,"2043_2011",2043,56.2928396484375,"night",1405,1366,0,39,0,1366,39,1405,0,0.972241992882562,0,0.0277580071174377,0,0.972241992882562,0.0277580071174377,1,0,"2011"
"241","2044_2011_roe","roe",15,15,"2044_2011",2044,14.7764053710937,"night",366,124,194,0,48,172,194,124,242,0.33879781420765,0.530054644808743,0,0.131147540983607,0.469945355191257,0.530054644808743,0.33879781420765,0.66120218579235,"2011"
"242","2045_2011_roe","roe",15,15,"2045_2011",2045,33.996237890625,"night",850,766,0,84,0,766,84,850,0,0.901176470588235,0,0.0988235294117647,0,0.901176470588235,0.0988235294117647,1,0,"2011"
"243","2046_2011_roe","roe",15,15,"2046_2011",2046,199.145683789063,"night",4980,3699,594,538,149,3848,1132,4237,743,0.742771084337349,0.119277108433735,0.108032128514056,0.0299196787148594,0.772690763052209,0.227309236947791,0.850803212851406,0.149196787148594,"2011"
"244","2047_2011_roe","roe",15,15,"2047_2011",2047,18.6231650390625,"night",462,165,234,1,62,227,235,166,296,0.357142857142857,0.506493506493506,0.00216450216450216,0.134199134199134,0.491341991341991,0.508658008658009,0.359307359307359,0.640692640692641,"2011"
"245","2047_2012_roe","roe",15,15,"2047_2012",2047,24.5927065429687,"night",614,282,248,1,83,365,249,283,331,0.45928338762215,0.403908794788274,0.00162866449511401,0.135179153094463,0.594462540716612,0.405537459283388,0.460912052117264,0.539087947882736,"2012"
"246","2048_2011_roe","roe",15,15,"2048_2011",2048,96.1170178710938,"night",2397,2161,125,108,3,2164,233,2269,128,0.901543596161869,0.0521485189820609,0.0450563204005006,0.00125156445556946,0.902795160617438,0.0972048393825615,0.94659991656237,0.0534000834376304,"2011"
"247","2049_2011_roe","roe",15,15,"2049_2011",2049,19.9914044921875,"night",499,314,121,1,63,377,122,315,184,0.629258517034068,0.24248496993988,0.00200400801603206,0.12625250501002,0.755511022044088,0.244488977955912,0.6312625250501,0.3687374749499,"2011"
"248","2054_2012_roe","roe",15,15,"2054_2012",2054,21.9128444335938,"night",552,492,25,4,31,523,29,496,56,0.891304347826087,0.0452898550724638,0.0072463768115942,0.0561594202898551,0.947463768115942,0.052536231884058,0.898550724637681,0.101449275362319,"2012"
"249","2054_2013_roe","roe",15,15,"2054_2013",2054,22.7766991210937,"night",569,548,4,0,17,565,4,548,21,0.963093145869947,0.0070298769771529,0,0.0298769771528998,0.992970123022847,0.0070298769771529,0.963093145869947,0.0369068541300527,"2013"
"250","2055_2012_roe","roe",15,15,"2055_2012",2055,18.0005986328125,"night",446,407,0,39,0,407,39,446,0,0.912556053811659,0,0.0874439461883408,0,0.912556053811659,0.0874439461883408,1,0,"2012"
"251","2056_2012_roe","roe",15,15,"2056_2012",2056,23.9005927734375,"night",597,482,6,100,9,491,106,582,15,0.807370184254606,0.0100502512562814,0.16750418760469,0.0150753768844221,0.822445561139028,0.177554438860972,0.974874371859296,0.0251256281407035,"2012"
"252","2056_2013_roe","roe",15,15,"2056_2013",2056,26.3326077148437,"night",657,540,0,117,0,540,117,657,0,0.821917808219178,0,0.178082191780822,0,0.821917808219178,0.178082191780822,1,0,"2013"
"253","2065_2012_roe","roe",15,15,"2065_2012",2065,23.897012890625,"night",598,571,3,7,17,588,10,578,20,0.954849498327759,0.00501672240802676,0.0117056856187291,0.0284280936454849,0.983277591973244,0.0167224080267559,0.966555183946488,0.0334448160535117,"2012"
"254","2066_2012_roe","roe",15,15,"2066_2012",2066,28.2121615234375,"night",703,603,89,1,10,613,90,604,99,0.857752489331437,0.126600284495021,0.00142247510668563,0.0142247510668563,0.871977240398293,0.128022759601707,0.859174964438122,0.140825035561878,"2012"
"255","2067_2012_roe","roe",15,15,"2067_2012",2067,71.4365852539062,"night",1785,1594,108,14,69,1663,122,1608,177,0.892997198879552,0.0605042016806723,0.00784313725490196,0.038655462184874,0.931652661064426,0.0683473389355742,0.900840336134454,0.0991596638655462,"2012"
"256","2068_2012_roe","roe",15,15,"2068_2012",2068,42.180994140625,"night",1055,486,536,5,28,514,541,491,564,0.460663507109005,0.508056872037915,0.004739336492891,0.0265402843601896,0.487203791469194,0.512796208530806,0.465402843601896,0.534597156398104,"2012"
"257","2072_2012_roe","roe",15,15,"2072_2012",2072,16.6982893554687,"night",419,368,35,3,13,381,38,371,48,0.878281622911695,0.0835322195704057,0.00715990453460621,0.0310262529832936,0.909307875894988,0.0906921241050119,0.885441527446301,0.114558472553699,"2012"
"258","2072_2013_roe","roe",15,15,"2072_2013",2072,20.1989069335938,"night",509,328,141,4,36,364,145,332,177,0.644400785854617,0.277013752455796,0.00785854616895874,0.0707269155206287,0.715127701375246,0.284872298624754,0.652259332023576,0.347740667976424,"2013"
"259","2076_2012_roe","roe",15,15,"2076_2012",2076,20.3411580078125,"night",510,200,250,4,56,256,254,204,306,0.392156862745098,0.490196078431373,0.00784313725490196,0.109803921568627,0.501960784313725,0.498039215686275,0.4,0.6,"2012"
"260","2076_2013_roe","roe",15,15,"2076_2013",2076,30.7578596679687,"night",772,416,282,4,70,486,286,420,352,0.538860103626943,0.365284974093264,0.00518134715025907,0.0906735751295337,0.629533678756477,0.370466321243523,0.544041450777202,0.455958549222798,"2013"
"261","2078_2012_roe","roe",15,15,"2078_2012",2078,17.2565466796875,"night",430,363,9,0,58,421,9,363,67,0.844186046511628,0.0209302325581395,0,0.134883720930233,0.97906976744186,0.0209302325581395,0.844186046511628,0.155813953488372,"2012"
"262","2078_2013_roe","roe",15,15,"2078_2013",2078,29.6842736328125,"night",744,663,13,0,68,731,13,663,81,0.891129032258065,0.0174731182795699,0,0.0913978494623656,0.98252688172043,0.0174731182795699,0.891129032258065,0.108870967741935,"2013"
"263","2079_2012_roe","roe",15,15,"2079_2012",2079,15.0675547851563,"night",378,358,6,0,14,372,6,358,20,0.947089947089947,0.0158730158730159,0,0.037037037037037,0.984126984126984,0.0158730158730159,0.947089947089947,0.0529100529100529,"2012"
"264","2081_2013_roe","roe",15,15,"2081_2013",2081,50.974256640625,"night",1282,1218,8,3,53,1271,11,1221,61,0.950078003120125,0.0062402496099844,0.00234009360374415,0.0413416536661466,0.991419656786271,0.00858034321372855,0.952418096723869,0.047581903276131,"2013"
"275","2246_2013_roe","roe",25,25,"2246_2013",2246,839.115891210938,"night",20979,12092,4547,504,3836,15928,5051,12596,8383,0.576385909719243,0.216740550073883,0.024024024024024,0.18284951618285,0.759235425902093,0.240764574097907,0.600409933743267,0.399590066256733,"2013"
"276","2246_2014_roe","roe",25,25,"2246_2014",2246,119.573167382812,"night",2987,2183,318,148,338,2521,466,2331,656,0.730833612320054,0.106461332440576,0.049548041513224,0.113157013726147,0.8439906260462,0.1560093739538,0.780381653833278,0.219618346166722,"2014"
"285","2252_2013_roe","roe",25,25,"2252_2013",2252,52.0909825195313,"night",1303,971,157,157,18,989,314,1128,175,0.745203376822717,0.120491174213354,0.120491174213354,0.0138142747505756,0.759017651573292,0.240982348426708,0.865694551036071,0.134305448963929,"2013"
"286","2252_2014_roe","roe",25,25,"2252_2014",2252,52.596284375,"night",1308,1086,75,134,13,1099,209,1220,88,0.830275229357798,0.0573394495412844,0.102446483180428,0.0099388379204893,0.840214067278288,0.159785932721713,0.932721712538226,0.0672782874617737,"2014"
"288","2256_2013_roe","roe",25,25,"2256_2013",2256,57.6691815429688,"night",1439,831,314,211,83,914,525,1042,397,0.577484364141765,0.218207088255733,0.146629603891591,0.0576789437109104,0.635163307852675,0.364836692147325,0.724113968033356,0.275886031966644,"2013"
"289","2256_2014_roe","roe",25,25,"2256_2014",2256,131.923162402344,"night",3298,1847,860,422,169,2016,1282,2269,1029,0.560036385688296,0.260764099454215,0.127956337174045,0.0512431776834445,0.61127956337174,0.38872043662826,0.687992722862341,0.312007277137659,"2014"
"290","2259_2013_roe","roe",25,25,"2259_2013",2259,251.327710058594,"night",6289,3535,1203,174,1377,4912,1377,3709,2580,0.562092542534584,0.191286373032279,0.0276673557004293,0.218953728732708,0.781046271267292,0.218953728732708,0.589759898235014,0.410240101764986,"2013"
"291","2259_2014_roe","roe",25,25,"2259_2014",2259,30.305144140625,"night",759,636,23,21,79,715,44,657,102,0.837944664031621,0.0303030303030303,0.0276679841897233,0.104084321475626,0.942028985507246,0.0579710144927536,0.865612648221344,0.134387351778656,"2014"
"293","2264_2013_roe","roe",25,25,"2264_2013",2264,14.6802606445313,"night",367,361,0,0,6,367,0,361,6,0.983651226158038,0,0,0.0163487738419619,1,0,0.983651226158038,0.0163487738419619,"2013"
"294","2264_2014_roe","roe",25,25,"2264_2014",2264,19.720519921875,"night",492,446,30,0,16,462,30,446,46,0.90650406504065,0.0609756097560976,0,0.032520325203252,0.939024390243902,0.0609756097560976,0.90650406504065,0.0934959349593496,"2014"
"295","2265_2014_roe","roe",25,25,"2265_2014",2265,27.3244321289062,"night",679,293,104,278,4,297,382,571,108,0.431516936671576,0.153166421207658,0.409425625920471,0.00589101620029455,0.43740795287187,0.56259204712813,0.840942562592047,0.159057437407953,"2014"
"296","2266_2013_roe","roe",25,25,"2266_2013",2266,95.9623659179688,"night",2395,1761,273,46,315,2076,319,1807,588,0.735281837160752,0.113987473903967,0.0192066805845511,0.131524008350731,0.866805845511482,0.133194154488518,0.754488517745303,0.245511482254697,"2013"
"297","2266_2014_roe","roe",25,25,"2266_2014",2266,78.8069331054687,"night",1971,1419,216,39,297,1716,255,1458,513,0.719939117199391,0.10958904109589,0.0197869101978691,0.150684931506849,0.87062404870624,0.12937595129376,0.73972602739726,0.26027397260274,"2014"
"298","2267_2013_roe","roe",25,25,"2267_2013",2267,64.1256122070313,"night",1599,1437,0,162,0,1437,162,1599,0,0.898686679174484,0,0.101313320825516,0,0.898686679174484,0.101313320825516,1,0,"2013"
"299","2267_2014_roe","roe",25,25,"2267_2014",2267,63.8093536132813,"night",1601,1524,0,77,0,1524,77,1601,0,0.951905059337914,0,0.0480949406620862,0,0.951905059337914,0.0480949406620862,1,0,"2014"
"300","2274_2013_roe","roe",25,25,"2274_2013",2274,102.731980273438,"night",2572,1630,646,195,101,1731,841,1825,747,0.633748055987558,0.251166407465008,0.0758164852255054,0.0392690513219285,0.673017107309487,0.326982892690513,0.709564541213064,0.290435458786936,"2013"
"301","2274_2014_roe","roe",25,25,"2274_2014",2274,102.121562109375,"night",2559,1607,662,184,106,1713,846,1791,768,0.627979679562329,0.258694802657288,0.0719030871434154,0.0414224306369676,0.669402110199297,0.330597889800703,0.699882766705744,0.300117233294256,"2014"
"302","2279_2013_roe","roe",25,25,"2279_2013",2279,335.828449609375,"night",8395,3386,3427,414,1168,4554,3841,3800,4595,0.403335318642049,0.408219178082192,0.0493150684931507,0.139130434782609,0.542465753424658,0.457534246575342,0.4526503871352,0.5473496128648,"2013"
"303","2279_2014_roe","roe",25,25,"2279_2014",2279,414.618064648437,"night",10363,4212,4335,540,1276,5488,4875,4752,5611,0.40644600984271,0.418315159702789,0.0521084628003474,0.123130367654154,0.529576377496864,0.470423622503136,0.458554472643057,0.541445527356943,"2014"
"304","2281_2013_roe","roe",25,25,"2281_2013",2281,14.4823340820312,"night",362,153,24,1,184,337,25,154,208,0.422651933701657,0.0662983425414365,0.00276243093922652,0.50828729281768,0.930939226519337,0.069060773480663,0.425414364640884,0.574585635359116,"2013"
"305","2281_2014_roe","roe",25,25,"2281_2014",2281,47.5735271484375,"night",1189,650,158,28,353,1003,186,678,511,0.546677880571909,0.132884777123633,0.0235492010092515,0.296888141295206,0.843566021867115,0.156433978132885,0.570227081581161,0.429772918418839,"2014"
"306","2282_2013_roe","roe",25,25,"2282_2013",2282,27.1845262695313,"night",682,343,278,56,5,348,334,399,283,0.502932551319648,0.407624633431085,0.0821114369501466,0.00733137829912024,0.510263929618768,0.489736070381232,0.585043988269795,0.414956011730205,"2013"
"307","2282_2014_roe","roe",25,25,"2282_2014",2282,293.383650878906,"night",7336,3954,2193,969,220,4174,3162,4923,2413,0.538985823336968,0.298936750272628,0.132088331515812,0.0299890948745911,0.568974918211559,0.431025081788441,0.671074154852781,0.328925845147219,"2014"
"314","2290_2014_roe","roe",25,25,"2290_2014",2290,541.624127441406,"night",13551,8750,2016,973,1812,10562,2989,9723,3828,0.645708803778319,0.148771308390525,0.0718028189801491,0.133717068851007,0.779425872629326,0.220574127370674,0.717511622758468,0.282488377241532,"2014"
"315","2292_2013_roe","roe",25,25,"2292_2013",2292,515.991986132812,"night",12904,9257,1763,321,1563,10820,2084,9578,3326,0.717374457532548,0.136624302541847,0.0248760074395536,0.121125232486051,0.838499690018599,0.161500309981401,0.742250464972102,0.257749535027898,"2013"
"316","2292_2014_roe","roe",25,25,"2292_2014",2292,159.949527148438,"night",3991,2984,517,259,231,3215,776,3243,748,0.747682285141569,0.129541468303683,0.0648960160360812,0.057880230518667,0.805562515660236,0.194437484339764,0.81257830117765,0.18742169882235,"2014"
"318","2295_2013_roe","roe",25,25,"2295_2013",2295,407.737444335937,"night",10192,4592,3564,1505,531,5123,5069,6097,4095,0.450549450549451,0.349686028257457,0.147664835164835,0.0520996860282575,0.502649136577708,0.497350863422292,0.598214285714286,0.401785714285714,"2013"
"319","2295_2014_roe","roe",25,25,"2295_2014",2295,127.224234277344,"night",3180,1552,972,395,261,1813,1367,1947,1233,0.488050314465409,0.305660377358491,0.124213836477987,0.0820754716981132,0.570125786163522,0.429874213836478,0.612264150943396,0.387735849056604,"2014"
"325","2301_2013_roe","roe",25,25,"2301_2013",2301,30.6806927734375,"night",768,695,7,40,26,721,47,735,33,0.904947916666667,0.00911458333333333,0.0520833333333333,0.0338541666666667,0.938802083333333,0.0611979166666667,0.95703125,0.04296875,"2013"
"326","2301_2014_roe","roe",25,25,"2301_2014",2301,33.055642578125,"night",828,755,6,46,21,776,52,801,27,0.911835748792271,0.0072463768115942,0.0555555555555556,0.0253623188405797,0.93719806763285,0.0628019323671498,0.967391304347826,0.0326086956521739,"2014"
"327","2302_2013_roe","roe",25,25,"2302_2013",2302,1650.01149990234,"night",41248,15271,16144,2452,7381,22652,18596,17723,23525,0.370224010861133,0.391388673390225,0.0594453064391001,0.178942009309542,0.549166020170675,0.450833979829325,0.429669317300233,0.570330682699767,"2013"
"328","2302_2014_roe","roe",25,25,"2302_2014",2302,184.837593847656,"night",4620,2237,1019,168,1196,3433,1187,2405,2215,0.484199134199134,0.220562770562771,0.0363636363636364,0.258874458874459,0.743073593073593,0.256926406926407,0.520562770562771,0.479437229437229,"2014"
"331","769_2005_roe","roe",1,1,"769_2005",769,45.7649444335937,"day",1141,11,1065,57,8,19,1122,68,1073,0.00964066608238387,0.93339176161262,0.0499561787905346,0.007011393514461,0.0166520595968449,0.983347940403155,0.0595968448729185,0.940403155127082,"2005"
"332","770_2005_roe","roe",1,1,"770_2005",770,46.586052734375,"day",1161,145,496,448,72,217,944,593,568,0.12489233419466,0.427217915590009,0.385874246339363,0.062015503875969,0.186907838070629,0.813092161929371,0.510766580534022,0.489233419465978,"2005"
"333","771_2005_roe","roe",1,1,"771_2005",771,251.690328320312,"day",6290,1247,3884,484,675,1922,4368,1731,4559,0.198251192368839,0.617488076311606,0.0769475357710652,0.10731319554849,0.305564387917329,0.694435612082671,0.275198728139905,0.724801271860095,"2005"
"334","772_2005_roe","roe",1,1,"772_2005",772,44.578234375,"day",1112,391,492,20,209,600,512,411,701,0.351618705035971,0.442446043165468,0.0179856115107914,0.18794964028777,0.539568345323741,0.460431654676259,0.369604316546763,0.630395683453237,"2005"
"335","774_2006_roe","roe",1,1,"774_2006",774,45.2367208007812,"day",1134,357,530,186,61,418,716,543,591,0.314814814814815,0.467372134038801,0.164021164021164,0.0537918871252205,0.368606701940035,0.631393298059965,0.478835978835979,0.521164021164021,"2006"
"336","774_2007_roe","roe",1,1,"774_2007",774,20.1731532226562,"day",502,145,186,164,7,152,350,309,193,0.288844621513944,0.370517928286853,0.326693227091633,0.0139442231075697,0.302788844621514,0.697211155378486,0.615537848605578,0.384462151394422,"2007"
"337","776_2006_roe","roe",1,1,"776_2006",776,54.546903515625,"day",1361,202,682,458,19,221,1140,660,701,0.148420279206466,0.501102130786187,0.33651726671565,0.0139603232916973,0.162380602498163,0.837619397501837,0.484937545922116,0.515062454077884,"2006"
"338","782_2006_roe","roe",1,1,"782_2006",782,377.004883007813,"day",9424,5515,2216,1189,504,6019,3405,6704,2720,0.585207979626486,0.235144312393888,0.126167232597623,0.0534804753820034,0.638688455008489,0.361311544991511,0.711375212224109,0.288624787775891,"2006"
"339","783_2006_roe","roe",1,1,"783_2006",783,33.0258802734375,"day",831,6,732,87,6,12,819,93,738,0.0072202166064982,0.88086642599278,0.104693140794224,0.0072202166064982,0.0144404332129964,0.985559566787004,0.111913357400722,0.888086642599278,"2006"
"340","784_2006_roe","roe",1,1,"784_2006",784,154.83317734375,"day",3862,1061,2085,639,77,1138,2724,1700,2162,0.274728120145003,0.539875712066287,0.165458311755567,0.0199378560331435,0.294665976178146,0.705334023821854,0.44018643190057,0.55981356809943,"2006"
"341","787_2006_roe","roe",1,1,"787_2006",787,100.100202929687,"day",2500,441,1394,212,453,894,1606,653,1847,0.1764,0.5576,0.0848,0.1812,0.3576,0.6424,0.2612,0.7388,"2006"
"342","789_2007_roe","roe",1,1,"789_2007",789,25.37587734375,"day",634,150,409,28,47,197,437,178,456,0.236593059936909,0.645110410094637,0.0441640378548896,0.0741324921135647,0.310725552050473,0.689274447949527,0.280757097791798,0.719242902208202,"2007"
"343","791_2007_roe","roe",1,1,"791_2007",791,133.414697460938,"day",3334,1142,1843,317,32,1174,2160,1459,1875,0.34253149370126,0.552789442111578,0.0950809838032394,0.00959808038392321,0.352129574085183,0.647870425914817,0.437612477504499,0.562387522495501,"2007"
"344","792_2006_roe","roe",1,1,"792_2006",792,28.5821600585938,"day",713,254,221,215,23,277,436,469,244,0.356241234221599,0.309957924263675,0.301542776998597,0.032258064516129,0.388499298737728,0.611500701262272,0.657784011220196,0.342215988779804,"2006"
"345","792_2007_roe","roe",1,1,"792_2007",792,46.9614478515625,"day",1174,478,311,333,52,530,644,811,363,0.407155025553663,0.264906303236797,0.283645655877342,0.0442930153321976,0.45144804088586,0.54855195911414,0.690800681431005,0.309199318568995,"2007"
"346","796_2005_roe","roe",1,1,"796_2005",796,17.139809375,"day",432,0,401,0,31,31,401,0,432,0,0.928240740740741,0,0.0717592592592593,0.0717592592592593,0.928240740740741,0,1,"2005"
"347","797_2005_roe","roe",1,1,"797_2005",797,102.400600488281,"day",2554,374,1908,199,73,447,2107,573,1981,0.146436961628818,0.747063429913861,0.0779169929522318,0.0285826155050901,0.175019577133908,0.824980422866092,0.224353954581049,0.775646045418951,"2005"
"348","799_2005_roe","roe",1,1,"799_2005",799,102.697820410156,"day",2566,176,2067,271,52,228,2338,447,2119,0.06858924395947,0.805533904910366,0.105611847233048,0.0202650038971161,0.0888542478565861,0.911145752143414,0.174201091192518,0.825798908807482,"2005"
"349","801_2005_roe","roe",1,1,"801_2005",801,20.1461232421875,"day",508,83,307,104,14,97,411,187,321,0.163385826771654,0.604330708661417,0.204724409448819,0.0275590551181102,0.190944881889764,0.809055118110236,0.368110236220472,0.631889763779528,"2005"
"354","1402_2010_roe","roe",2,2,"1402_2010",1402,47.9696139648438,"day",1199,1,1062,2,134,135,1064,3,1196,0.000834028356964137,0.885738115095913,0.00166805671392827,0.111759799833194,0.112593828190158,0.887406171809841,0.00250208507089241,0.997497914929108,"2010"
"355","14_2006_roe","roe",2,2,"14_2006",14,36.3777213867187,"day",911,0,650,0,261,261,650,0,911,0,0.713501646542261,0,0.286498353457739,0.286498353457739,0.713501646542261,0,1,"2006"
"356","14_2007_roe","roe",2,2,"14_2007",14,44.4802670898437,"day",1111,0,842,0,269,269,842,0,1111,0,0.757875787578758,0,0.242124212421242,0.242124212421242,0.757875787578758,0,1,"2007"
"357","14_2010_roe","roe",2,2,"14_2010",14,144.089452148437,"day",3603,0,3148,0,455,455,3148,0,3603,0,0.873716347488204,0,0.126283652511796,0.126283652511796,0.873716347488204,0,1,"2010"
"358","1429_2010_roe","roe",2,2,"1429_2010",1429,314.439131054687,"day",7851,50,7208,535,58,108,7743,585,7266,0.00636861546299834,0.918099605145841,0.0681441854540823,0.00738759393707808,0.0137562094000764,0.986243790599924,0.0745128009170806,0.925487199082919,"2010"
"363","1956_2010_roe","roe",2,2,"1956_2010",1956,3939.20500351562,"day",98481,27117,52865,15381,3118,30235,68246,42498,55983,0.275352606086453,0.536804053573786,0.156182410820361,0.0316609295193997,0.307013535605853,0.692986464394147,0.431535016906815,0.568464983093185,"2010"
"364","1958_2010_roe","roe",2,2,"1958_2010",1958,99.0557086914063,"day",2477,0,2368,0,109,109,2368,0,2477,0,0.955995155429956,0,0.0440048445700444,0.0440048445700444,0.955995155429956,0,1,"2010"
"366","1962_2010_roe","roe",2,2,"1962_2010",1962,5499.93845751953,"day",137498,31910,62638,39610,3340,35250,102248,71520,65978,0.232076102925133,0.455555717174068,0.288076917482436,0.0242912624183624,0.256367365343496,0.743632634656504,0.52015302040757,0.47984697959243,"2010"
"367","1964_2010_roe","roe",2,2,"1964_2010",1964,922.857903320313,"day",23077,3280,17968,1017,812,4092,18985,4297,18780,0.142132859557135,0.778610737964207,0.0440698531004897,0.0351865493781687,0.177319408935304,0.822680591064696,0.186202712657624,0.813797287342376,"2010"
"370","1973_2010_roe","roe",2,2,"1973_2010",1973,34.5011557617187,"day",860,55,630,93,82,137,723,148,712,0.063953488372093,0.732558139534884,0.108139534883721,0.0953488372093023,0.159302325581395,0.840697674418605,0.172093023255814,0.827906976744186,"2010"
"371","1973_2011_roe","roe",2,2,"1973_2011",1973,75.422675390625,"day",1890,353,1244,120,173,526,1364,473,1417,0.186772486772487,0.658201058201058,0.0634920634920635,0.0915343915343915,0.278306878306878,0.721693121693122,0.25026455026455,0.74973544973545,"2011"
"373","1982_2010_roe","roe",2,2,"1982_2010",1982,116.906567675781,"day",2921,0,2565,0,356,356,2565,0,2921,0,0.878123930160904,0,0.121876069839096,0.121876069839096,0.878123930160904,0,1,"2010"
"374","1985_2010_roe","roe",2,2,"1985_2010",1985,74.1680655273438,"day",1847,0,1700,0,147,147,1700,0,1847,0,0.92041147807255,0,0.0795885219274499,0.0795885219274499,0.92041147807255,0,1,"2010"
"377","1991_2010_roe","roe",2,2,"1991_2010",1991,4529.69500498047,"day",113243,60083,38502,12683,1975,62058,51185,72766,40477,0.530567010764462,0.339994525047906,0.111998092597335,0.017440371590297,0.548007382354759,0.451992617645241,0.642565103361797,0.357434896638203,"2010"
"378","1993_2010_roe","roe",2,2,"1993_2010",1993,19.7392588867188,"day",491,42,418,23,8,50,441,65,426,0.0855397148676171,0.85132382892057,0.0468431771894094,0.0162932790224033,0.10183299389002,0.89816700610998,0.132382892057026,0.867617107942974,"2010"
"379","1994_2010_roe","roe",2,2,"1994_2010",1994,390.40669921875,"day",9770,1027,7125,1305,313,1340,8430,2332,7438,0.105117707267144,0.729273285568065,0.133572159672467,0.0320368474923234,0.137154554759468,0.862845445240532,0.238689866939611,0.761310133060389,"2010"
"380","1994_2011_roe","roe",2,2,"1994_2011",1994,32.338325,"day",810,139,446,222,3,142,668,361,449,0.171604938271605,0.550617283950617,0.274074074074074,0.0037037037037037,0.175308641975309,0.824691358024691,0.445679012345679,0.554320987654321,"2011"
"381","1996_2010_roe","roe",2,2,"1996_2010",1996,96.6780704101563,"day",2412,356,1146,638,272,628,1784,994,1418,0.14759535655058,0.475124378109453,0.264510779436153,0.112769485903814,0.260364842454395,0.739635157545605,0.412106135986733,0.587893864013267,"2010"
"382","2000_2010_roe","roe",2,2,"2000_2010",2000,19.4776999023438,"day",484,191,265,26,2,193,291,217,267,0.394628099173554,0.547520661157025,0.0537190082644628,0.00413223140495868,0.398760330578512,0.601239669421488,0.448347107438017,0.551652892561983,"2010"
"384","2008_2010_roe","roe",2,2,"2008_2010",2008,68.1343323242187,"day",1706,0,1547,0,159,159,1547,0,1706,0,0.906799531066823,0,0.093200468933177,0.093200468933177,0.906799531066823,0,1,"2010"
"385","2008_2011_roe","roe",2,2,"2008_2011",2008,74.9821010742187,"day",1872,0,1698,0,174,174,1698,0,1872,0,0.907051282051282,0,0.092948717948718,0.092948717948718,0.907051282051282,0,1,"2011"
"386","2011_2010_roe","roe",2,2,"2011_2010",2011,88.7782608398438,"day",2213,331,1812,59,11,342,1871,390,1823,0.149570718481699,0.818798011748757,0.026660641662901,0.00497062810664257,0.154541346588342,0.845458653411658,0.1762313601446,0.8237686398554,"2010"
"387","2013_2010_roe","roe",2,2,"2013_2010",2013,21.9145884765625,"day",543,87,417,35,4,91,452,122,421,0.160220994475138,0.767955801104972,0.0644567219152855,0.00736648250460405,0.167587476979742,0.832412523020258,0.224677716390424,0.775322283609576,"2010"
"388","2014_2010_roe","roe",2,2,"2014_2010",2014,123.643280664063,"day",3090,1085,1887,59,59,1144,1946,1144,1946,0.351132686084142,0.610679611650485,0.0190938511326861,0.0190938511326861,0.370226537216828,0.629773462783171,0.370226537216828,0.629773462783171,"2010"
"389","2014_2011_roe","roe",2,2,"2014_2011",2014,63.7210765625,"day",1593,711,807,70,5,716,877,781,812,0.446327683615819,0.506591337099812,0.0439422473320778,0.00313873195229127,0.449466415568111,0.550533584431889,0.490269930947897,0.509730069052103,"2011"
"393","2030_2010_roe","roe",2,2,"2030_2010",2030,99.039725,"day",2478,1258,1150,63,7,1265,1213,1321,1157,0.507667473769169,0.46408393866021,0.0254237288135593,0.00282485875706215,0.510492332526231,0.489507667473769,0.533091202582728,0.466908797417272,"2010"
"395","21_2010_roe","roe",2,2,"21_2010",21,182.915601171875,"day",4573,0,3994,0,579,579,3994,0,4573,0,0.873387273124863,0,0.126612726875137,0.126612726875137,0.873387273124863,0,1,"2010"
"416","1728_2006_roe","roe",8,8,"1728_2006",1728,29.0407013183594,"day",719,349,0,370,0,349,370,719,0,0.485396383866481,0,0.514603616133519,0,0.485396383866481,0.514603616133519,1,0,"2006"
"417","1728_2011_roe","roe",8,8,"1728_2011",1728,39.86725078125,"day",998,517,0,481,0,517,481,998,0,0.518036072144289,0,0.481963927855711,0,0.518036072144289,0.481963927855711,1,0,"2011"
"456","1777_2008_roe","roe",8,8,"1777_2008",1777,662.044510107422,"day",16540,15485,0,1055,0,15485,1055,16540,0,0.936215235792019,0,0.0637847642079807,0,0.936215235792019,0.0637847642079807,1,0,"2008"
"457","1777_2011_roe","roe",8,8,"1777_2011",1777,101.647404052734,"day",2541,2058,387,45,51,2109,432,2103,438,0.809917355371901,0.152302243211334,0.0177095631641086,0.0200708382526564,0.829988193624557,0.170011806375443,0.827626918536009,0.172373081463991,"2011"
"476","1807_2009_roe","roe",8,8,"1807_2009",1807,533.47484453125,"day",13336,12585,14,737,0,12585,751,13322,14,0.94368626274745,0.0010497900419916,0.0552639472105579,0,0.94368626274745,0.0563137372525495,0.998950209958008,0.0010497900419916,"2009"
"477","1807_2011_roe","roe",8,8,"1807_2011",1807,64.8954006835937,"day",1623,1472,0,151,0,1472,151,1623,0,0.906962415280345,0,0.093037584719655,0,0.906962415280345,0.093037584719655,1,0,"2011"
"483","1817_2009_roe","roe",8,8,"1817_2009",1817,47.0393799804688,"day",1174,931,0,243,0,931,243,1174,0,0.793015332197615,0,0.206984667802385,0,0.793015332197615,0.206984667802385,1,0,"2009"
"484","1817_2011_roe","roe",8,8,"1817_2011",1817,207.577357177734,"day",5186,4796,0,390,0,4796,390,5186,0,0.924797531816429,0,0.0752024681835712,0,0.924797531816429,0.0752024681835712,1,0,"2011"
"490","1827_2011_roe","roe",8,8,"1827_2011",1827,62.5777930664063,"day",1566,1453,0,113,0,1453,113,1566,0,0.927841634738186,0,0.0721583652618135,0,0.927841634738186,0.0721583652618135,1,0,"2011"
"497","1835_2011_roe","roe",8,8,"1835_2011",1835,41.8169876464844,"day",1049,485,503,44,17,502,547,529,520,0.46234509056244,0.479504289799809,0.0419447092469018,0.0162059103908484,0.478551000953289,0.521448999046711,0.504289799809342,0.495710200190658,"2011"
"503","1857_2011_roe","roe",8,8,"1857_2011",1857,75.6737215332031,"day",1892,1620,0,272,0,1620,272,1892,0,0.856236786469345,0,0.143763213530655,0,0.856236786469345,0.143763213530655,1,0,"2011"
"504","1859_2011_roe","roe",8,8,"1859_2011",1859,68.5429442382813,"day",1717,1058,0,659,0,1058,659,1717,0,0.616191030867793,0,0.383808969132207,0,0.616191030867793,0.383808969132207,1,0,"2011"
"505","1860_2011_roe","roe",8,8,"1860_2011",1860,134.898776269531,"day",3372,3084,0,288,0,3084,288,3372,0,0.914590747330961,0,0.0854092526690391,0,0.914590747330961,0.0854092526690391,1,0,"2011"
"506","1861_2011_roe","roe",8,8,"1861_2011",1861,55.3580150390625,"day",1382,1233,0,149,0,1233,149,1382,0,0.892185238784371,0,0.10781476121563,0,0.892185238784371,0.10781476121563,1,0,"2011"
"507","1865_2011_roe","roe",8,8,"1865_2011",1865,70.2188747070312,"day",1757,1412,0,345,0,1412,345,1757,0,0.803642572566875,0,0.196357427433125,0,0.803642572566875,0.196357427433125,1,0,"2011"
"508","1866_2011_roe","roe",8,8,"1866_2011",1866,131.747193212891,"day",3295,3143,0,150,2,3145,150,3293,2,0.953869499241275,0,0.0455235204855842,0.000606980273141123,0.954476479514416,0.0455235204855842,0.999393019726859,0.000606980273141123,"2011"
"509","1867_2011_roe","roe",8,8,"1867_2011",1867,328.368178222656,"day",8217,5588,575,1892,162,5750,2467,7480,737,0.680053547523427,0.0699768772057929,0.230254350736278,0.0197152245345016,0.699768772057929,0.300231227942071,0.910307898259705,0.0896921017402945,"2011"
"510","1869_2011_roe","roe",8,8,"1869_2011",1869,32.7468645507812,"day",814,34,759,15,6,40,774,49,765,0.0417690417690418,0.932432432432432,0.0184275184275184,0.00737100737100737,0.0491400491400491,0.950859950859951,0.0601965601965602,0.93980343980344,"2011"
"511","1871_2011_roe","roe",8,8,"1871_2011",1871,47.63174375,"day",1196,340,800,48,8,348,848,388,808,0.284280936454849,0.668896321070234,0.040133779264214,0.00668896321070234,0.290969899665552,0.709030100334448,0.324414715719064,0.675585284280936,"2011"
"512","1873_2011_roe","roe",8,8,"1873_2011",1873,69.8773869628906,"day",1747,654,992,54,47,701,1046,708,1039,0.374356038923869,0.567830566685747,0.0309101316542645,0.0269032627361191,0.401259301659989,0.598740698340011,0.405266170578134,0.594733829421866,"2011"
"513","1874_2011_roe","roe",8,8,"1874_2011",1874,218.715615820313,"day",5462,3116,2063,263,20,3136,2326,3379,2083,0.570487001098499,0.377700476016111,0.0481508604906628,0.00366166239472721,0.574148663493226,0.425851336506774,0.618637861589161,0.381362138410839,"2011"
"514","1875_2011_roe","roe",8,8,"1875_2011",1875,36.4505034179687,"day",916,568,255,40,53,621,295,608,308,0.620087336244541,0.278384279475983,0.0436681222707424,0.0578602620087336,0.677947598253275,0.322052401746725,0.663755458515284,0.336244541484716,"2011"
"515","1876_2011_roe","roe",8,8,"1876_2011",1876,40.9507046875,"day",1023,909,0,114,0,909,114,1023,0,0.888563049853372,0,0.111436950146628,0,0.888563049853372,0.111436950146628,1,0,"2011"
"516","1878_2011_roe","roe",8,8,"1878_2011",1878,773.861343652344,"day",19345,15091,2016,1740,498,15589,3756,16831,2514,0.780098216593435,0.104212974928922,0.0899457224088912,0.0257430860687516,0.805841302662187,0.194158697337813,0.870043939002326,0.129956060997674,"2011"
"517","1880_2011_roe","roe",8,8,"1880_2011",1880,163.075625097656,"day",4082,2593,223,1240,26,2619,1463,3833,249,0.635227829495345,0.0546300832925037,0.303772660460559,0.00636942675159236,0.641597256246938,0.358402743753062,0.939000489955904,0.060999510044096,"2011"
"518","1881_2011_roe","roe",8,8,"1881_2011",1881,25.676197265625,"day",645,573,0,72,0,573,72,645,0,0.888372093023256,0,0.111627906976744,0,0.888372093023256,0.111627906976744,1,0,"2011"
"519","1882_2011_roe","roe",8,8,"1882_2011",1882,27.5112956054687,"day",690,445,169,4,72,517,173,449,241,0.644927536231884,0.244927536231884,0.00579710144927536,0.104347826086957,0.749275362318841,0.250724637681159,0.650724637681159,0.349275362318841,"2011"
"520","1882_2013_roe","roe",8,8,"1882_2013",1882,35.9857718261719,"day",900,442,337,6,115,557,343,448,452,0.491111111111111,0.374444444444444,0.00666666666666667,0.127777777777778,0.618888888888889,0.381111111111111,0.497777777777778,0.502222222222222,"2013"
"521","1883_2011_roe","roe",8,8,"1883_2011",1883,33.1925696289062,"day",832,645,0,187,0,645,187,832,0,0.775240384615385,0,0.224759615384615,0,0.775240384615385,0.224759615384615,1,0,"2011"
"542","1936_2011_roe","roe",8,8,"1936_2011",1936,37.6279333007813,"day",947,528,0,419,0,528,419,947,0,0.557550158394931,0,0.442449841605069,0,0.557550158394931,0.442449841605069,1,0,"2011"
"543","1937_2010_roe","roe",8,8,"1937_2010",1937,133.1482453125,"day",3330,3123,0,207,0,3123,207,3330,0,0.937837837837838,0,0.0621621621621622,0,0.937837837837838,0.0621621621621622,1,0,"2010"
"544","1937_2011_roe","roe",8,8,"1937_2011",1937,104.60429765625,"day",2620,2476,0,144,0,2476,144,2620,0,0.945038167938931,0,0.0549618320610687,0,0.945038167938931,0.0549618320610687,1,0,"2011"
"545","1937_2012_roe","roe",8,8,"1937_2012",1937,68.0654844726563,"day",1697,1588,0,109,0,1588,109,1697,0,0.935769004124926,0,0.0642309958750737,0,0.935769004124926,0.0642309958750737,1,0,"2012"
"564","1453_2010_roe","roe",15,15,"1453_2010",1453,25.9550404296875,"day",647,419,165,1,62,481,166,420,227,0.647604327666152,0.255023183925811,0.00154559505409583,0.0958268933539413,0.743431221020093,0.256568778979907,0.649149922720247,0.350850077279753,"2010"
"565","1454_2010_roe","roe",15,15,"1454_2010",1454,15.413689453125,"day",385,298,37,0,50,348,37,298,87,0.774025974025974,0.0961038961038961,0,0.12987012987013,0.903896103896104,0.0961038961038961,0.774025974025974,0.225974025974026,"2010"
"566","1455_2010_roe","roe",15,15,"1455_2010",1455,11.61438203125,"day",292,0,261,0,31,31,261,0,292,0,0.893835616438356,0,0.106164383561644,0.106164383561644,0.893835616438356,0,1,"2010"
"567","1457_2010_roe","roe",15,15,"1457_2010",1457,15.9044134765625,"day",397,367,9,0,21,388,9,367,30,0.924433249370277,0.0226700251889169,0,0.052896725440806,0.977329974811083,0.0226700251889169,0.924433249370277,0.0755667506297229,"2010"
"568","2041_2011_roe","roe",15,15,"2041_2011",2041,28.1641299804688,"day",701,465,198,4,34,499,202,469,232,0.663338088445078,0.282453637660485,0.00570613409415121,0.0485021398002853,0.711840228245364,0.288159771754636,0.66904422253923,0.33095577746077,"2011"
"569","2043_2011_roe","roe",15,15,"2043_2011",2043,77.2545188476562,"day",1933,1891,0,42,0,1891,42,1933,0,0.978272115882049,0,0.0217278841179514,0,0.978272115882049,0.0217278841179514,1,0,"2011"
"570","2044_2011_roe","roe",15,15,"2044_2011",2044,3.8524865234375,"day",96,4,74,0,18,22,74,4,92,0.0416666666666667,0.770833333333333,0,0.1875,0.229166666666667,0.770833333333333,0.0416666666666667,0.958333333333333,"2011"
"571","2045_2011_roe","roe",15,15,"2045_2011",2045,22.12926328125,"day",550,469,0,81,0,469,81,550,0,0.852727272727273,0,0.147272727272727,0,0.852727272727273,0.147272727272727,1,0,"2011"
"572","2046_2011_roe","roe",15,15,"2046_2011",2046,217.418829589844,"day",5439,4053,613,579,194,4247,1192,4632,807,0.745173745173745,0.11270454127597,0.106453392167678,0.0356683213826071,0.780842066556352,0.219157933443648,0.851627137341423,0.148372862658577,"2011"
"573","2047_2011_roe","roe",15,15,"2047_2011",2047,16.22043671875,"day",406,143,214,1,48,191,215,144,262,0.352216748768473,0.527093596059113,0.00246305418719212,0.118226600985222,0.470443349753695,0.529556650246305,0.354679802955665,0.645320197044335,"2011"
"574","2047_2012_roe","roe",15,15,"2047_2012",2047,21.6061400390625,"day",542,268,213,7,54,322,220,275,267,0.494464944649447,0.392988929889299,0.0129151291512915,0.0996309963099631,0.59409594095941,0.40590405904059,0.507380073800738,0.492619926199262,"2012"
"575","2048_2011_roe","roe",15,15,"2048_2011",2048,141.942977734375,"day",3547,3114,282,104,47,3161,386,3218,329,0.87792500704821,0.0795038060332676,0.0293205525796448,0.0132506343388779,0.891175641387088,0.108824358612912,0.907245559627854,0.0927544403721455,"2011"
"576","2049_2011_roe","roe",15,15,"2049_2011",2049,13.8344375,"day",348,230,78,3,37,267,81,233,115,0.660919540229885,0.224137931034483,0.00862068965517241,0.10632183908046,0.767241379310345,0.232758620689655,0.669540229885057,0.330459770114943,"2011"
"577","2054_2012_roe","roe",15,15,"2054_2012",2054,26.6229305664063,"day",666,518,108,1,39,557,109,519,147,0.777777777777778,0.162162162162162,0.0015015015015015,0.0585585585585586,0.836336336336336,0.163663663663664,0.779279279279279,0.220720720720721,"2012"
"578","2054_2013_roe","roe",15,15,"2054_2013",2054,30.8700612304687,"day",775,668,57,8,42,710,65,676,99,0.861935483870968,0.0735483870967742,0.0103225806451613,0.0541935483870968,0.916129032258065,0.0838709677419355,0.872258064516129,0.127741935483871,"2013"
"579","2055_2012_roe","roe",15,15,"2055_2012",2055,15.8016555664063,"day",393,353,0,40,0,353,40,393,0,0.898218829516539,0,0.101781170483461,0,0.898218829516539,0.101781170483461,1,0,"2012"
"580","2056_2012_roe","roe",15,15,"2056_2012",2056,14.0474469726562,"day",352,241,0,111,0,241,111,352,0,0.684659090909091,0,0.315340909090909,0,0.684659090909091,0.315340909090909,1,0,"2012"
"581","2056_2013_roe","roe",15,15,"2056_2013",2056,15.501790234375,"day",388,279,0,109,0,279,109,388,0,0.719072164948454,0,0.280927835051546,0,0.719072164948454,0.280927835051546,1,0,"2013"
"582","2065_2012_roe","roe",15,15,"2065_2012",2065,65.3529037109375,"day",1633,1311,266,9,47,1358,275,1320,313,0.802816901408451,0.162890385793019,0.00551132884262094,0.0287813839559094,0.83159828536436,0.16840171463564,0.808328230251072,0.191671769748928,"2012"
"583","2066_2012_roe","roe",15,15,"2066_2012",2066,21.856937890625,"day",545,446,87,0,12,458,87,446,99,0.818348623853211,0.159633027522936,0,0.0220183486238532,0.840366972477064,0.159633027522936,0.818348623853211,0.181651376146789,"2012"
"584","2067_2012_roe","roe",15,15,"2067_2012",2067,75.3444266601562,"day",1877,1650,131,14,82,1732,145,1664,213,0.879062333510922,0.0697922216302611,0.00745871070857752,0.0436867341502397,0.922749067661161,0.0772509323388386,0.886521044219499,0.113478955780501,"2012"
"585","2068_2012_roe","roe",15,15,"2068_2012",2068,50.4505799804688,"day",1262,436,796,5,25,461,801,441,821,0.345483359746434,0.630744849445325,0.00396196513470681,0.0198098256735341,0.365293185419968,0.634706814580032,0.349445324881141,0.650554675118859,"2012"
"586","2072_2012_roe","roe",15,15,"2072_2012",2072,18.5652366210937,"day",468,351,91,4,22,373,95,355,113,0.75,0.194444444444444,0.00854700854700855,0.047008547008547,0.797008547008547,0.202991452991453,0.758547008547009,0.241452991452991,"2012"
"587","2072_2013_roe","roe",15,15,"2072_2013",2072,23.1701922851563,"day",576,360,154,4,58,418,158,364,212,0.625,0.267361111111111,0.00694444444444444,0.100694444444444,0.725694444444444,0.274305555555556,0.631944444444444,0.368055555555556,"2013"
"588","2076_2012_roe","roe",15,15,"2076_2012",2076,12.1752422851562,"day",302,28,235,3,36,64,238,31,271,0.0927152317880795,0.778145695364238,0.00993377483443709,0.119205298013245,0.211920529801325,0.788079470198676,0.102649006622517,0.897350993377483,"2012"
"589","2076_2013_roe","roe",15,15,"2076_2013",2076,8.667009375,"day",216,33,144,2,37,70,146,35,181,0.152777777777778,0.666666666666667,0.00925925925925926,0.171296296296296,0.324074074074074,0.675925925925926,0.162037037037037,0.837962962962963,"2013"
"590","2078_2012_roe","roe",15,15,"2078_2012",2078,15.1538081054687,"day",379,275,34,0,70,345,34,275,104,0.725593667546174,0.0897097625329815,0,0.184696569920844,0.910290237467018,0.0897097625329815,0.725593667546174,0.274406332453826,"2012"
"591","2078_2013_roe","roe",15,15,"2078_2013",2078,19.4681202148438,"day",483,379,29,0,75,454,29,379,104,0.784679089026915,0.0600414078674948,0,0.15527950310559,0.939958592132505,0.0600414078674948,0.784679089026915,0.215320910973085,"2013"
"592","2079_2012_roe","roe",15,15,"2079_2012",2079,9.58460927734375,"day",241,209,16,0,16,225,16,209,32,0.867219917012448,0.0663900414937759,0,0.0663900414937759,0.933609958506224,0.0663900414937759,0.867219917012448,0.132780082987552,"2012"
"593","2081_2013_roe","roe",15,15,"2081_2013",2081,42.8547024414063,"day",1070,1020,9,0,41,1061,9,1020,50,0.953271028037383,0.00841121495327103,0,0.0383177570093458,0.991588785046729,0.00841121495327103,0.953271028037383,0.0467289719626168,"2013"
"604","2246_2013_roe","roe",25,25,"2246_2013",2246,879.524043554688,"day",21989,12869,4721,508,3891,16760,5229,13377,8612,0.585247169039065,0.214698258220019,0.0231024603210696,0.176952112419846,0.762199281458911,0.237800718541089,0.608349629360135,0.391650370639865,"2013"
"605","2246_2014_roe","roe",25,25,"2246_2014",2246,152.652460839844,"day",3816,2401,616,188,611,3012,804,2589,1227,0.6291928721174,0.161425576519916,0.0492662473794549,0.160115303983229,0.789308176100629,0.210691823899371,0.678459119496855,0.321540880503145,"2014"
"614","2252_2013_roe","roe",25,25,"2252_2013",2252,42.002106640625,"day",1047,404,339,149,155,559,488,553,494,0.385864374403056,0.32378223495702,0.142311365807068,0.148042024832856,0.533906399235912,0.466093600764088,0.528175740210124,0.471824259789876,"2013"
"615","2252_2014_roe","roe",25,25,"2252_2014",2252,33.3074909179687,"day",839,431,197,103,108,539,300,534,305,0.513706793802145,0.234803337306317,0.122765196662694,0.128724672228844,0.642431466030989,0.357568533969011,0.636471990464839,0.363528009535161,"2014"
"617","2256_2013_roe","roe",25,25,"2256_2013",2256,68.4465500976563,"day",1710,593,751,250,116,709,1001,843,867,0.346783625730994,0.439181286549708,0.146198830409357,0.0678362573099415,0.414619883040936,0.585380116959064,0.492982456140351,0.507017543859649,"2013"
"618","2256_2014_roe","roe",25,25,"2256_2014",2256,109.219034375,"day",2729,1180,1018,381,150,1330,1399,1561,1168,0.432392817882008,0.373030414071088,0.139611579333089,0.0549651887138146,0.487358006595823,0.512641993404177,0.572004397215097,0.427995602784903,"2014"
"619","2259_2013_roe","roe",25,25,"2259_2013",2259,287.27592109375,"day",7177,3766,1601,201,1609,5375,1802,3967,3210,0.52473178208165,0.223073707677303,0.0280061306952766,0.224188379545771,0.748920161627421,0.251079838372579,0.552737912776926,0.447262087223074,"2013"
"620","2259_2014_roe","roe",25,25,"2259_2014",2259,61.78259140625,"day",1550,768,296,44,442,1210,340,812,738,0.495483870967742,0.190967741935484,0.0283870967741936,0.285161290322581,0.780645161290323,0.219354838709677,0.523870967741936,0.476129032258065,"2014"
"622","2264_2013_roe","roe",25,25,"2264_2013",2264,18.4824338867187,"day",460,354,48,24,34,388,72,378,82,0.769565217391304,0.104347826086957,0.0521739130434783,0.0739130434782609,0.843478260869565,0.156521739130435,0.821739130434783,0.178260869565217,"2013"
"623","2264_2014_roe","roe",25,25,"2264_2014",2264,19.2785340820312,"day",482,356,62,1,63,419,63,357,125,0.738589211618257,0.128630705394191,0.0020746887966805,0.130705394190871,0.869294605809129,0.130705394190871,0.740663900414938,0.259336099585062,"2014"
"624","2265_2014_roe","roe",25,25,"2265_2014",2265,39.8181182617188,"day",993,327,345,317,4,331,662,644,349,0.329305135951662,0.347432024169184,0.319234642497482,0.0040281973816717,0.333333333333333,0.666666666666667,0.648539778449144,0.351460221550856,"2014"
"625","2266_2013_roe","roe",25,25,"2266_2013",2266,74.1739342773437,"day",1855,1060,467,54,274,1334,521,1114,741,0.571428571428571,0.251752021563342,0.0291105121293801,0.147708894878706,0.719137466307278,0.280862533692722,0.600539083557951,0.399460916442049,"2013"
"626","2266_2014_roe","roe",25,25,"2266_2014",2266,49.0474658203125,"day",1227,637,376,46,168,805,422,683,544,0.519152404237979,0.306438467807661,0.0374898125509372,0.136919315403423,0.656071719641402,0.343928280358598,0.556642216788916,0.443357783211084,"2014"
"627","2267_2013_roe","roe",25,25,"2267_2013",2267,41.48447578125,"day",1034,886,0,148,0,886,148,1034,0,0.856866537717602,0,0.143133462282398,0,0.856866537717602,0.143133462282398,1,0,"2013"
"628","2267_2014_roe","roe",25,25,"2267_2014",2267,42.4945903320313,"day",1059,950,0,109,0,950,109,1059,0,0.897072710103872,0,0.102927289896128,0,0.897072710103872,0.102927289896128,1,0,"2014"
"629","2274_2013_roe","roe",25,25,"2274_2013",2274,115.709388476562,"day",2891,1381,1090,275,145,1526,1365,1656,1235,0.477689380837081,0.377032168799723,0.0951227948806641,0.050155655482532,0.527845036319613,0.472154963680387,0.572812175717745,0.427187824282255,"2013"
"630","2274_2014_roe","roe",25,25,"2274_2014",2274,118.532852636719,"day",2964,1399,1169,230,166,1565,1399,1629,1335,0.471997300944669,0.394399460188934,0.0775978407557355,0.0560053981106613,0.528002699055331,0.471997300944669,0.549595141700405,0.450404858299595,"2014"
"631","2279_2013_roe","roe",25,25,"2279_2013",2279,352.934188671875,"day",8826,3637,3466,456,1267,4904,3922,4093,4733,0.412077951506911,0.392703376387945,0.0516655336505778,0.143553138454566,0.555631089961477,0.444368910038523,0.463743485157489,0.536256514842511,"2013"
"632","2279_2014_roe","roe",25,25,"2279_2014",2279,473.726568847656,"day",11843,5157,4484,691,1511,6668,5175,5848,5995,0.435447099552478,0.378620282023136,0.0583467026935743,0.127585915730811,0.56303301528329,0.43696698471671,0.493793802246053,0.506206197753947,"2014"
"633","2281_2013_roe","roe",25,25,"2281_2013",2281,8.98337607421875,"day",224,46,25,0,153,199,25,46,178,0.205357142857143,0.111607142857143,0,0.683035714285714,0.888392857142857,0.111607142857143,0.205357142857143,0.794642857142857,"2013"
"634","2281_2014_roe","roe",25,25,"2281_2014",2281,44.0424572265625,"day",1108,544,185,28,351,895,213,572,536,0.490974729241877,0.166967509025271,0.0252707581227437,0.316787003610108,0.807761732851986,0.192238267148014,0.516245487364621,0.483754512635379,"2014"
"635","2282_2013_roe","roe",25,25,"2282_2013",2282,13.5613588867188,"day",337,10,317,9,1,11,326,19,318,0.029673590504451,0.940652818991098,0.0267062314540059,0.0029673590504451,0.0326409495548961,0.967359050445104,0.056379821958457,0.943620178041543,"2013"
"636","2282_2014_roe","roe",25,25,"2282_2014",2282,278.896413085938,"day",6973,3014,2879,810,270,3284,3689,3824,3149,0.432238634733974,0.412878244657966,0.116162340456045,0.0387207801520149,0.470959414885989,0.529040585114011,0.548400975190019,0.451599024809981,"2014"
"643","2290_2014_roe","roe",25,25,"2290_2014",2290,461.905112011719,"day",11555,7197,1816,800,1742,8939,2616,7997,3558,0.622847252271744,0.15716140199048,0.0692340977931631,0.150757247944613,0.773604500216357,0.226395499783643,0.692081350064907,0.307918649935093,"2014"
"644","2292_2013_roe","roe",25,25,"2292_2013",2292,469.397870019531,"day",11734,8364,1677,257,1436,9800,1934,8621,3113,0.712800409067667,0.142918016021817,0.0219021646497358,0.122379410260781,0.835179819328447,0.164820180671553,0.734702573717402,0.265297426282598,"2013"
"645","2292_2014_roe","roe",25,25,"2292_2014",2292,152.465222363281,"day",3812,2581,743,254,234,2815,997,2835,977,0.67707240293809,0.194910807974816,0.0666316894018888,0.0613850996852046,0.738457502623295,0.261542497376705,0.743704092339979,0.256295907660021,"2014"
"647","2295_2013_roe","roe",25,25,"2295_2013",2295,424.317751074219,"day",10603,4622,3819,1622,540,5162,5441,6244,4359,0.435914363859285,0.360181080826181,0.152975572951052,0.050928982363482,0.486843346222767,0.513156653777233,0.588889936810337,0.411110063189663,"2013"
"648","2295_2014_roe","roe",25,25,"2295_2014",2295,184.052870214844,"day",4600,2107,1673,530,290,2397,2203,2637,1963,0.45804347826087,0.363695652173913,0.115217391304348,0.0630434782608696,0.521086956521739,0.478913043478261,0.573260869565217,0.426739130434783,"2014"
"654","2301_2013_roe","roe",25,25,"2301_2013",2301,20.026891015625,"day",502,386,16,67,33,419,83,453,49,0.768924302788845,0.0318725099601594,0.133466135458167,0.0657370517928287,0.834661354581673,0.165338645418327,0.902390438247012,0.097609561752988,"2013"
"655","2301_2014_roe","roe",25,25,"2301_2014",2301,15.8094341796875,"day",393,291,11,62,29,320,73,353,40,0.740458015267176,0.0279898218829517,0.157760814249364,0.0737913486005089,0.814249363867684,0.185750636132316,0.898218829516539,0.101781170483461,"2014"
"656","2302_2013_roe","roe",25,25,"2302_2013",2302,1616.69057402344,"day",40409,15346,15538,2512,7013,22359,18050,17858,22551,0.379766883615036,0.384518300378628,0.0621643693236655,0.17355044668267,0.553317330297706,0.446682669702294,0.441931252938702,0.558068747061298,"2013"
"657","2302_2014_roe","roe",25,25,"2302_2014",2302,177.804081347656,"day",4443,1734,1402,153,1154,2888,1555,1887,2556,0.390276839972991,0.315552554580239,0.0344361917623228,0.259734413684447,0.650011253657439,0.349988746342561,0.424713031735314,0.575286968264686,"2014"
"660","113_2011_red","red",3,3,"113_2011",113,3601.59136904297,"night",90047,43019,31327,5896,9805,52824,37223,48915,41132,0.477739402756338,0.34789609870401,0.0654769176096927,0.108887580929959,0.586626983686297,0.413373016313703,0.543216320366031,0.456783679633969,"2011"
"661","117_2011_red","red",3,3,"117_2011",117,62.4317631835938,"night",1566,673,374,384,135,808,758,1057,509,0.429757343550447,0.23882503192848,0.245210727969349,0.0862068965517241,0.515964240102171,0.484035759897829,0.674968071519796,0.325031928480204,"2011"
"662","119_2006_red","red",3,3,"119_2006",119,381.884893359375,"night",9544,899,7149,946,550,1449,8095,1845,7699,0.0941953059513831,0.749056999161777,0.0991198658843252,0.0576278290025147,0.151823134953898,0.848176865046102,0.193315171835708,0.806684828164292,"2006"
"663","120_2005_red","red",3,3,"120_2005",120,565.286658300781,"night",14133,5898,6555,1140,540,6438,7695,7038,7095,0.417321163234982,0.463808108681809,0.0806622797707493,0.0382084483124602,0.455529611547442,0.544470388452558,0.497983443005731,0.502016556994269,"2005"
"664","120_2006_red","red",3,3,"120_2006",120,488.491199121094,"night",12206,5466,5072,1175,493,5959,6247,6641,5565,0.447812551204326,0.415533344256923,0.0962641323939046,0.0403899721448468,0.488202523349173,0.511797476650827,0.54407668359823,0.45592331640177,"2006"
"665","122_2011_red","red",3,3,"122_2011",122,294.450557519531,"night",7362,4033,2080,289,960,4993,2369,4322,3040,0.547813094267862,0.28253192067373,0.0392556370551481,0.13039934800326,0.678212442271122,0.321787557728878,0.58706873132301,0.41293126867699,"2011"
"666","127_2008_red","red",3,3,"127_2008",127,397.153351855469,"night",9930,4265,2549,2573,543,4808,5122,6838,3092,0.429506545820745,0.256696878147029,0.259113796576032,0.0546827794561934,0.484189325276939,0.515810674723061,0.688620342396777,0.311379657603223,"2008"
"667","137_2010_red","red",3,3,"137_2010",137,327.025745703125,"night",8179,2220,4924,621,414,2634,5545,2841,5338,0.271426824795207,0.602029587969189,0.075926152341362,0.0506174348942414,0.322044259689449,0.677955740310551,0.347352977136569,0.652647022863431,"2010"
"668","137_2011_red","red",3,3,"137_2011",137,212.114630078125,"night",5307,1476,3137,390,304,1780,3527,1866,3441,0.278123233465235,0.591106086301112,0.073487846240814,0.0572828339928396,0.335406067458074,0.664593932541926,0.351611079706049,0.648388920293951,"2011"
"669","138_2010_red","red",3,3,"138_2010",138,658.643495800781,"night",16464,7393,6408,2032,631,8024,8440,9425,7039,0.449040330417881,0.389212827988338,0.123420796890185,0.0383260447035957,0.487366375121477,0.512633624878523,0.572461127308066,0.427538872691934,"2010"
"670","287_2012_red","red",8,8,"287_2012",287,8962.39003662109,"night",224063,70866,106926,41269,5002,75868,148195,112135,111928,0.316277118488996,0.477213997848819,0.184184805166404,0.0223240784957802,0.338601196984777,0.661398803015223,0.500461923655401,0.4995380763446,"2012"
"673","289_2011_red","red",8,8,"289_2011",289,3030.798640625,"night",75770,28548,32856,13039,1327,29875,45895,41587,34183,0.376771809423255,0.433628084994061,0.172086577801241,0.0175135277814438,0.394285337204698,0.605714662795302,0.548858387224495,0.451141612775505,"2011"
"675","291_2011_red","red",8,8,"291_2011",291,1184.55484794922,"night",29609,24025,224,5275,85,24110,5499,29300,309,0.811408693302712,0.00756526731736972,0.178155290621095,0.00287074875882333,0.814279442061535,0.185720557938465,0.989563983923807,0.010436016076193,"2011"
"680","295_2011_red","red",8,8,"295_2011",295,2013.71416904297,"night",50324,12210,32442,3846,1826,14036,36288,16056,34268,0.242627772037199,0.64466258643987,0.0764247675065575,0.0362848740163739,0.278912646053573,0.721087353946427,0.319052539543756,0.680947460456244,"2011"
"684","300_2011_red","red",8,8,"300_2011",300,1849.76957216797,"night",46247,8814,33821,1764,1848,10662,35585,10578,35669,0.19058533526499,0.731312301338465,0.0381430146820334,0.0399593487145112,0.230544683979501,0.769455316020499,0.228728349947024,0.771271650052976,"2011"
"686","306_2011_red","red",8,8,"306_2011",306,75.8147154296875,"night",1895,0,1599,7,289,289,1606,7,1888,0,0.843799472295515,0.00369393139841689,0.152506596306069,0.152506596306069,0.847493403693931,0.00369393139841689,0.996306068601583,"2011"
"688","310_2011_red","red",8,8,"310_2011",310,2427.1551125,"night",60665,29133,13694,17288,550,29683,30982,46421,14244,0.480227478776889,0.225731476139454,0.284974861946757,0.00906618313689937,0.489293661913789,0.510706338086211,0.765202340723646,0.234797659276354,"2011"
"692","313_2013_red","red",8,8,"313_2013",313,162.182791113281,"night",4054,76,3299,301,378,454,3600,377,3677,0.018746916625555,0.813764183522447,0.0742476566354218,0.0932412432165762,0.111988159842131,0.888011840157869,0.0929945732609768,0.907005426739023,"2013"
"696","315_2011_red","red",8,8,"315_2011",315,316.383477734375,"night",7919,84,7313,19,503,587,7332,103,7816,0.0106073999242329,0.923475186260892,0.00239929284000505,0.0635181209748706,0.0741255208991034,0.925874479100897,0.0130066927642379,0.986993307235762,"2011"
"697","344_2013_red","red",8,8,"344_2013",344,145.717008789063,"night",3641,520,2577,94,450,970,2671,614,3027,0.14281790716836,0.707772589947817,0.0258170832188959,0.123592419664927,0.266410326833288,0.733589673166712,0.168634990387256,0.831365009612744,"2013"
"698","345_2011_red","red",8,8,"345_2011",345,616.954337304688,"night",15431,4224,9004,1386,817,5041,10390,5610,9821,0.273734689909922,0.583500745253062,0.089819195126693,0.0529453697103234,0.326680059620245,0.673319940379755,0.363553885036615,0.636446114963385,"2011"
"700","348_2011_red","red",8,8,"348_2011",348,1800.0094171875,"night",45007,7480,31881,2593,3053,10533,34474,10073,34934,0.166196369453641,0.708356477881218,0.0576132601595307,0.0678338925056102,0.234030261959251,0.765969738040749,0.223809629613171,0.776190370386829,"2011"
"702","351_2011_red","red",8,8,"351_2011",351,200.377236328125,"night",5002,260,3890,156,696,956,4046,416,4586,0.0519792083166733,0.777688924430228,0.031187524990004,0.139144342263095,0.191123550579768,0.808876449420232,0.0831667333066773,0.916833266693323,"2011"
"708","365_2011_red","red",8,8,"365_2011",365,1642.84066035156,"night",41079,6062,28638,5512,867,6929,34150,11574,29505,0.147569317656223,0.697144526400351,0.134180481511234,0.0211056744321916,0.168674992088415,0.831325007911585,0.281749799167458,0.718250200832542,"2011"
"715","371_2011_red","red",8,8,"371_2011",371,2276.28767314453,"night",56918,28238,11575,16646,459,28697,28221,44884,12034,0.49611722126568,0.203362732351804,0.292455813626621,0.00806423275589445,0.504181454021575,0.495818545978425,0.788573034892301,0.211426965107699,"2011"
"719","376_2011_red","red",8,8,"376_2011",376,4333.70026601562,"night",108339,45276,38407,23245,1411,46687,61652,68521,39818,0.417910447761194,0.35450761037115,0.21455800773498,0.0130239341326761,0.43093438189387,0.56906561810613,0.632468455496174,0.367531544503826,"2011"
"720","376_2012_red","red",8,8,"376_2012",376,4357.77298037109,"night",108942,44816,41407,21296,1423,46239,62703,66112,42830,0.411374860017257,0.380082979934277,0.195480163756861,0.0130619962916047,0.424436856308862,0.575563143691138,0.606855023774118,0.393144976225882,"2012"
"727","387_2013_red","red",8,8,"387_2013",387,132.735442089844,"night",3315,1003,1866,175,271,1274,2041,1178,2137,0.302564102564103,0.56289592760181,0.052790346907994,0.0817496229260935,0.384313725490196,0.615686274509804,0.355354449472097,0.644645550527904,"2013"
"728","389_2013_red","red",8,8,"389_2013",389,2037.49531337891,"night",50936,12165,32894,3809,2068,14233,36703,15974,34962,0.238829118894299,0.645790796293388,0.0747801162242814,0.040599968588032,0.279429087482331,0.720570912517669,0.31360923511858,0.68639076488142,"2013"
"729","390_2013_red","red",8,8,"390_2013",390,1132.80406503906,"night",28332,6630,19238,1375,1089,7719,20613,8005,20327,0.234011012282931,0.679020189185373,0.0485316956092051,0.0384371029224905,0.272448115205421,0.727551884794579,0.282542707892136,0.717457292107864,"2013"
"730","391_2013_red","red",8,8,"391_2013",391,160.211326464844,"night",4005,996,2550,173,286,1282,2723,1169,2836,0.248689138576779,0.636704119850187,0.0431960049937578,0.0714107365792759,0.320099875156055,0.679900124843945,0.291885143570537,0.708114856429463,"2013"
"731","392_2013_red","red",8,8,"392_2013",392,355.524597851562,"night",8878,1307,6163,404,1004,2311,6567,1711,7167,0.147217841856274,0.694187880153188,0.0455057445370579,0.113088533453481,0.260306375309754,0.739693624690246,0.192723586393332,0.807276413606668,"2013"
"732","393_2013_red","red",8,8,"393_2013",393,1911.14352333984,"night",47787,24707,10543,11870,667,25374,22413,36577,11210,0.517023458262707,0.220624856132421,0.248393914662984,0.013957770941888,0.530981229204595,0.469018770795405,0.765417372925691,0.234582627074309,"2013"
"733","394_2013_red","red",8,8,"394_2013",394,1681.54167519531,"night",42029,6845,29308,3743,2133,8978,33051,10588,31441,0.162863736943539,0.697328035404126,0.0890575554973946,0.0507506721549406,0.21361440909848,0.78638559090152,0.251921292440934,0.748078707559066,"2013"
"734","395_2013_red","red",8,8,"395_2013",395,1998.01465175781,"night",49946,20918,18036,10170,822,21740,28206,31088,18858,0.418812317302687,0.361109998798703,0.203619909502262,0.0164577743963481,0.435270091699035,0.564729908300965,0.622432226804949,0.377567773195051,"2013"
"735","396_2013_red","red",8,8,"396_2013",396,494.00384453125,"night",12352,450,10006,815,1081,1531,10821,1265,11087,0.0364313471502591,0.810071243523316,0.0659812176165803,0.0875161917098446,0.123947538860104,0.876052461139896,0.102412564766839,0.897587435233161,"2013"
"736","397_2013_red","red",8,8,"397_2013",397,255.9069140625,"night",6404,107,5427,399,471,578,5826,506,5898,0.0167083073079325,0.847439100562149,0.0623048094940662,0.0735477826358526,0.0902560899437851,0.909743910056215,0.0790131168019988,0.920986883198001,"2013"
"737","398_2013_red","red",8,8,"398_2013",398,119.4260515625,"night",2988,531,1752,450,255,786,2202,981,2007,0.177710843373494,0.586345381526104,0.150602409638554,0.0853413654618474,0.263052208835341,0.736947791164659,0.328313253012048,0.671686746987952,"2013"
"738","399_2013_red","red",8,8,"399_2013",399,477.026263671875,"night",11928,4197,5428,1452,851,5048,6880,5649,6279,0.351861167002012,0.455063715627096,0.121730382293763,0.0713447350771294,0.423205902079141,0.576794097920858,0.473591549295775,0.526408450704225,"2013"
"739","444_2010_red","red",14,14,"444_2010",444,1529.33617802734,"night",38229,3123,33954,666,486,3609,34620,3789,34440,0.0816919092835282,0.888173899395747,0.0174213293572942,0.0127128619634309,0.0944047712469591,0.905595228753041,0.0991132386408224,0.900886761359178,"2010"
"740","445_2009_red","red",14,14,"445_2009",445,4743.73170283203,"night",118578,28645,81273,6354,2306,30951,87627,34999,83579,0.241570949079931,0.68539695390376,0.0535849820371401,0.0194471149791698,0.2610180640591,0.7389819359409,0.295155931117071,0.704844068882929,"2009"
"741","445_2010_red","red",14,14,"445_2010",445,3644.35916445312,"night",91101,18338,67041,4118,1604,19942,71159,22456,68645,0.201293070328536,0.735897520334574,0.0452025773591947,0.0176068319776951,0.218899902306232,0.781100097693768,0.246495647687731,0.753504352312269,"2010"
"742","446_2009_red","red",14,14,"446_2009",446,2057.49923623047,"night",51445,4309,45221,1152,763,5072,46373,5461,45984,0.0837593546505977,0.879016425308582,0.022392846729517,0.0148313733113033,0.0985907279619011,0.901409272038099,0.106152201380115,0.893847798619885,"2009"
"743","446_2010_red","red",14,14,"446_2010",446,1113.43740966797,"night",27842,2880,23899,571,492,3372,24470,3451,24391,0.103440844766899,0.858379426765319,0.0205085841534373,0.0176711443143452,0.121111989081244,0.878888010918756,0.123949428920336,0.876050571079664,"2010"
"744","447_2013_red","red",14,14,"447_2013",447,3550.13879677734,"night",88763,36676,44557,5692,1838,38514,50249,42368,46395,0.413190180593265,0.501977175174341,0.0641258181900116,0.0207068260423825,0.433897006635648,0.566102993364352,0.477315998783277,0.522684001216723,"2013"
"745","448_2010_red","red",14,14,"448_2010",448,653.798105078125,"night",16348,1738,14022,401,187,1925,14423,2139,14209,0.106312698801077,0.857719598727673,0.0245289943724003,0.01143870809885,0.117751406899927,0.882248593100073,0.130841693173477,0.869158306826523,"2010"
"746","448_2011_red","red",14,14,"448_2011",448,533.942432128906,"night",13358,1012,11965,258,123,1135,12223,1270,12088,0.0757598442880671,0.895717921844588,0.0193142686030843,0.00920796526426112,0.0849678095523282,0.915032190447672,0.0950741128911514,0.904925887108849,"2011"
"747","449_2009_red","red",14,14,"449_2009",449,746.210843066406,"night",18653,13579,3151,1596,327,13906,4747,15175,3478,0.727979413499169,0.168927250308261,0.0855626440787005,0.0175306921138691,0.745510105613038,0.254489894386962,0.813542057577869,0.18645794242213,"2009"
"748","449_2010_red","red",14,14,"449_2010",449,1077.41099160156,"night",26918,18710,6026,1846,336,19046,7872,20556,6362,0.695073928226466,0.223865071699235,0.0685786462590088,0.0124823538152909,0.707556282041756,0.292443717958244,0.763652574485474,0.236347425514526,"2010"
"749","451_2010_red","red",14,14,"451_2010",451,1206.40673173828,"night",30156,14763,13074,1997,322,15085,15071,16760,13396,0.489554317548747,0.433545563072025,0.06622231065128,0.010677808727948,0.500232126276695,0.499767873723306,0.555776628200026,0.444223371799973,"2010"
"750","451_2011_red","red",14,14,"451_2011",451,1205.04072158203,"night",30143,15606,12373,1874,290,15896,14247,17480,12663,0.517732143449557,0.410476727598447,0.0621703214676708,0.00962080748432472,0.527352950933882,0.472647049066118,0.579902464917228,0.420097535082772,"2011"
"751","452_2010_red","red",14,14,"452_2010",452,1439.04086083984,"night",35975,23566,11254,407,748,24314,11661,23973,12002,0.655066018068103,0.312828353022933,0.0113134120917304,0.0207922168172342,0.675858234885337,0.324141765114663,0.666379430159833,0.333620569840167,"2010"
"752","456_2009_red","red",14,14,"456_2009",456,1607.25930878906,"night",40179,11137,26038,1463,1541,12678,27501,12600,27579,0.277184598919834,0.648049976355808,0.0364120560491799,0.0383533686751786,0.315537967595012,0.684462032404988,0.313596654969014,0.686403345030986,"2009"
"753","458_2008_red","red",14,14,"458_2008",458,180.440841113281,"night",4514,4045,0,469,0,4045,469,4514,0,0.896101019051839,0,0.103898980948161,0,0.896101019051839,0.103898980948161,1,0,"2008"
"754","458_2009_red","red",14,14,"458_2009",458,586.730004492188,"night",14662,10835,2297,1326,204,11039,3623,12161,2501,0.738985131632792,0.156663483835766,0.0904378665939162,0.0139135179375256,0.752898649570318,0.247101350429682,0.829422998226709,0.170577001773291,"2009"
"755","458_2010_red","red",14,14,"458_2010",458,246.798170898437,"night",6168,5062,210,852,44,5106,1062,5914,254,0.820687418936446,0.0340466926070039,0.138132295719844,0.00713359273670558,0.827821011673152,0.172178988326848,0.958819714656291,0.0411802853437095,"2010"
"756","458_2011_red","red",14,14,"458_2011",458,93.566007421875,"night",2339,1893,0,446,0,1893,446,2339,0,0.80932022231723,0,0.19067977768277,0,0.80932022231723,0.19067977768277,1,0,"2011"
"757","459_2010_red","red",14,14,"459_2010",459,753.286158691406,"night",18834,6291,8813,2852,878,7169,11665,9143,9691,0.334023574386747,0.467930338749071,0.151428268025911,0.0466178188382712,0.380641393225019,0.619358606774981,0.485451842412658,0.514548157587342,"2010"
"758","459_2011_red","red",14,14,"459_2011",459,840.688145800781,"night",21008,5460,12350,2110,1088,6548,14460,7570,13438,0.25990099009901,0.587871287128713,0.100437928408225,0.0517897943640518,0.311690784463062,0.688309215536938,0.360338918507235,0.639661081492765,"2011"
"759","459_2012_red","red",14,14,"459_2012",459,1079.48123984375,"night",26987,7643,14760,3225,1359,9002,17985,10868,16119,0.283210434653722,0.546930003334939,0.119501982435988,0.0503575795753511,0.333568014229073,0.666431985770927,0.40271241708971,0.59728758291029,"2012"
"760","460_2010_red","red",14,14,"460_2010",460,8260.3458328125,"night",206511,167979,14338,23966,228,168207,38304,191945,14566,0.813414297543472,0.0694297156083695,0.116051929437173,0.00110405741098537,0.814518354954458,0.185481645045542,0.929466226980645,0.0705337730193549,"2010"
"761","460_2011_red","red",14,14,"460_2011",460,8013.87868222656,"night",200347,155602,20598,23699,448,156050,44297,179301,21046,0.776662490578846,0.102811621836114,0.118289767253815,0.00223612033122532,0.778898610910071,0.221101389089929,0.89495225783266,0.10504774216734,"2011"
"762","461_2010_red","red",14,14,"461_2010",461,1005.45944736328,"night",25133,17457,6505,359,812,18269,6864,17816,7317,0.694584808817093,0.258823061313811,0.0142840090717384,0.0323081207973581,0.726892929614451,0.273107070385549,0.708868817888831,0.291131182111169,"2010"
"763","461_2011_red","red",14,14,"461_2011",461,801.7397140625,"night",20049,11222,7693,303,831,12053,7996,11525,8524,0.55972866477131,0.383709910718739,0.0151129732156217,0.0414484512943289,0.601177116065639,0.398822883934361,0.574841637986932,0.425158362013068,"2011"
"764","462_2010_red","red",14,14,"462_2010",462,1514.82447871094,"night",37870,27639,8862,355,1014,28653,9217,27994,9876,0.72983892263005,0.234011090573013,0.00937417480855558,0.0267758119883813,0.756614734618431,0.243385265381569,0.739213097438606,0.260786902561394,"2010"
"765","463_2010_red","red",14,14,"463_2010",463,3795.62824804687,"night",94887,53626,30944,8772,1545,55171,39716,62398,32489,0.565156449250161,0.326114220072297,0.0924468051471751,0.0162825255303677,0.581438974780528,0.418561025219472,0.657603254397336,0.342396745602664,"2010"
"766","465_2010_red","red",14,14,"465_2010",465,4589.97857275391,"night",114755,67028,37265,8573,1889,68917,45838,75601,39154,0.584096553527079,0.32473530565117,0.0747069844451222,0.0164611563766285,0.600557709903708,0.399442290096292,0.658803537972202,0.341196462027798,"2010"
"767","466_2013_red","red",14,14,"466_2013",466,1002.52729755859,"night",25070,12849,10043,1339,839,13688,11382,14188,10882,0.512524930195453,0.400598324690866,0.0534104507379338,0.0334662943757479,0.545991224571201,0.454008775428799,0.565935380933386,0.434064619066613,"2013"
"768","724_2013_red","red",17,17,"724_2013",724,306.178944824219,"night",7657,827,6471,222,137,964,6693,1049,6608,0.108005746375865,0.845109050541988,0.0289930782290714,0.0178921248530756,0.125897871228941,0.874102128771059,0.136998824604937,0.863001175395063,"2013"
"769","724_2014_red","red",17,17,"724_2014",724,297.362949902344,"night",7438,476,6699,146,117,593,6845,622,6816,0.0639956977682173,0.900645334767411,0.0196289325087389,0.0157300349556332,0.0797257327238505,0.920274267276149,0.0836246302769562,0.916375369723044,"2014"
"770","725_2009_red","red",17,17,"725_2009",725,304.68809921875,"night",7617,1290,4912,612,803,2093,5524,1902,5715,0.169358014966522,0.644873309701982,0.0803465931469082,0.105422082184587,0.274780097151109,0.725219902848891,0.24970460811343,0.750295391886569,"2009"
"771","725_2010_red","red",17,17,"725_2010",725,215.502380761719,"night",5383,1084,3292,439,568,1652,3731,1523,3860,0.201374698123723,0.611554895039941,0.0815530373397734,0.105517369496563,0.306892067620286,0.693107932379714,0.282927735463496,0.717072264536504,"2010"
"772","727_2002_red","red",17,17,"727_2002",727,407.726281054687,"night",10188,1877,6632,694,985,2862,7326,2571,7617,0.184236356497841,0.650961915979584,0.0681193561052218,0.0966823714173538,0.280918727915194,0.719081272084806,0.252355712603062,0.747644287396938,"2002"
"773","730_2013_red","red",17,17,"730_2013",730,1475.97301708984,"night",36900,4028,27516,3952,1404,5432,31468,7980,28920,0.109159891598916,0.745691056910569,0.10710027100271,0.0380487804878049,0.147208672086721,0.852791327913279,0.216260162601626,0.783739837398374,"2013"
"774","742_2009_red","red",17,17,"742_2009",742,442.497603808594,"night",11072,2730,5803,1437,1102,3832,7240,4167,6905,0.246567919075144,0.524114884393064,0.129786849710983,0.0995303468208092,0.346098265895954,0.653901734104046,0.376354768786127,0.623645231213873,"2009"
"775","742_2010_red","red",17,17,"742_2010",742,722.811766308594,"night",18072,9187,6465,1184,1236,10423,7649,10371,7701,0.508355467020806,0.35773572377158,0.0655157149181054,0.0683930942895086,0.576748561310314,0.423251438689686,0.573871181938911,0.426128818061089,"2010"
"776","743_2004_red","red",17,17,"743_2004",743,369.275599511719,"night",9232,607,7518,505,602,1209,8023,1112,8120,0.0657495667244367,0.814341421143847,0.0547010398613518,0.065207972270364,0.130957538994801,0.869042461005199,0.120450606585789,0.879549393414211,"2004"
"777","744_2009_red","red",17,17,"744_2009",744,77.7715606445312,"night",1943,37,1293,16,597,634,1309,53,1890,0.0190427174472465,0.665465774575399,0.00823468862583634,0.307256819351518,0.326299536798765,0.673700463201235,0.0272774060730829,0.972722593926917,"2009"
"778","744_2010_red","red",17,17,"744_2010",744,493.879172949219,"night",12343,1223,8909,610,1601,2824,9519,1833,10510,0.0990845013367901,0.721785627481163,0.0494207242971725,0.129709146884874,0.228793648221664,0.771206351778336,0.148505225633963,0.851494774366037,"2010"
"779","745_2010_red","red",17,17,"745_2010",745,930.063621679687,"night",23251,1646,19855,917,833,2479,20772,2563,20688,0.0707926540793944,0.853941765945551,0.0394391639069287,0.0358264160681261,0.106619070147521,0.893380929852479,0.110231817986323,0.889768182013677,"2010"
"780","747_2002_red","red",17,17,"747_2002",747,439.559273925781,"night",10987,479,9788,275,445,924,10063,754,10233,0.0435969782470192,0.89087102939838,0.0250295804132156,0.0405024119413853,0.0840993901884045,0.915900609811595,0.0686265586602348,0.931373441339765,"2002"
"781","748_2005_red","red",17,17,"748_2005",748,4513.67379384766,"night",112839,14311,83822,7715,6991,21302,91537,22026,90813,0.126826717712848,0.74284600182561,0.0683717509017272,0.0619555295598153,0.188782247272663,0.811217752727337,0.195198468614575,0.804801531385425,"2005"
"782","752_2002_red","red",17,17,"752_2002",752,400.545332324219,"night",10016,1167,8199,397,253,1420,8596,1564,8452,0.11651357827476,0.818590255591054,0.0396365814696486,0.0252595846645367,0.141773162939297,0.858226837060703,0.156150159744409,0.843849840255591,"2002"
"783","754_2010_red","red",17,17,"754_2010",754,209.937559863281,"night",5249,537,3812,391,509,1046,4203,928,4321,0.102305200990665,0.726233568298724,0.0744903791198323,0.0969708515907792,0.199276052581444,0.800723947418556,0.176795580110497,0.823204419889503,"2010"
"784","757_2012_red","red",17,17,"757_2012",757,173.391372753906,"night",4339,137,3524,161,517,654,3685,298,4041,0.0315740954136898,0.812168702466006,0.0371053238073289,0.119151878312975,0.150725973726665,0.849274026273335,0.0686794192210187,0.931320580778981,"2012"
"785","757_2013_red","red",17,17,"757_2013",757,184.1835171875,"night",4609,19,4063,3,524,543,4066,22,4587,0.00412236927750054,0.881536124972879,0.000650900412236928,0.113690605337383,0.117812974614884,0.882187025385116,0.00477326968973747,0.995226730310263,"2013"
"786","758_2009_red","red",17,17,"758_2009",758,328.397987207031,"night",8213,1511,5312,641,749,2260,5953,2152,6061,0.183976622427858,0.646779495921101,0.0780469986606599,0.0911968829903811,0.275173505418239,0.724826494581761,0.262023621088518,0.737976378911482,"2009"
"787","758_2010_red","red",17,17,"758_2010",758,208.527950976562,"night",5213,1332,2958,466,457,1789,3424,1798,3415,0.255515058507577,0.567427584883944,0.0893919048532515,0.0876654517552273,0.343180510262805,0.656819489737196,0.344906963360829,0.655093036639171,"2010"
"788","759_2014_red","red",17,17,"759_2014",759,58.2173467773437,"night",1456,420,765,101,170,590,866,521,935,0.288461538461538,0.525412087912088,0.0693681318681319,0.116758241758242,0.40521978021978,0.59478021978022,0.35782967032967,0.64217032967033,"2014"
"789","760_2009_red","red",17,17,"760_2009",760,264.931625195313,"night",6628,1322,4413,292,601,1923,4705,1614,5014,0.199456849728425,0.665811707905854,0.044055522027761,0.0906759203379602,0.290132770066385,0.709867229933615,0.243512371756186,0.756487628243814,"2009"
"790","760_2010_red","red",17,17,"760_2010",760,320.44941796875,"night",8004,1325,5504,381,794,2119,5885,1706,6298,0.165542228885557,0.687656171914043,0.0476011994002999,0.0992003998001,0.264742628685657,0.735257371314343,0.213143428285857,0.786856571714143,"2010"
"791","762_2009_red","red",17,17,"762_2009",762,138.054032324219,"night",3455,392,2474,136,453,845,2610,528,2927,0.113458755426918,0.716063675832127,0.0393632416787265,0.131114327062229,0.244573082489146,0.755426917510854,0.152821997105644,0.847178002894356,"2009"
"792","762_2010_red","red",17,17,"762_2010",762,107.866613183594,"night",2699,46,1835,75,743,789,1910,121,2578,0.0170433493886625,0.67988143756947,0.0277880696554279,0.275287143386439,0.292330492775102,0.707669507224898,0.0448314190440904,0.95516858095591,"2010"
"793","763_2014_red","red",17,17,"763_2014",763,817.08416171875,"night",20444,876,17976,613,979,1855,18589,1489,18955,0.0428487575816866,0.879279984347486,0.0299843474858149,0.0478869105850127,0.0907356681666993,0.909264331833301,0.0728331050675015,0.927166894932498,"2014"
"794","702_2005_red","red",21,21,"702_2005",702,199.684542578125,"night",4994,54,3776,1045,119,173,4821,1099,3895,0.0108129755706848,0.756107328794553,0.209251101321586,0.0238285943131758,0.0346415698838606,0.965358430116139,0.220064076892271,0.779935923107729,"2005"
"795","702_2006_red","red",21,21,"702_2006",702,520.125703808594,"night",13008,206,10591,1878,333,539,12469,2084,10924,0.0158364083640836,0.814191266912669,0.144372693726937,0.02559963099631,0.0414360393603936,0.958563960639606,0.160209102091021,0.839790897908979,"2006"
"796","703_2009_red","red",21,21,"703_2009",703,212.674899414063,"night",5312,1576,2977,699,60,1636,3676,2275,3037,0.296686746987952,0.56042921686747,0.131588855421687,0.0112951807228916,0.307981927710843,0.692018072289157,0.428275602409639,0.571724397590361,"2009"
"797","703_2010_red","red",21,21,"703_2010",703,132.024596582031,"night",3300,1164,1476,625,35,1199,2101,1789,1511,0.352727272727273,0.447272727272727,0.189393939393939,0.0106060606060606,0.363333333333333,0.636666666666667,0.542121212121212,0.457878787878788,"2010"
"798","706_2010_red","red",21,21,"706_2010",706,44.6411467773437,"night",1124,188,786,145,5,193,931,333,791,0.167259786476868,0.699288256227758,0.129003558718861,0.00444839857651246,0.171708185053381,0.828291814946619,0.29626334519573,0.703736654804271,"2010"
"799","706_2011_red","red",21,21,"706_2011",706,48.6527369140625,"night",1218,188,871,154,5,193,1025,342,876,0.154351395730706,0.715106732348112,0.126436781609195,0.00410509031198686,0.158456486042693,0.841543513957307,0.280788177339901,0.719211822660099,"2011"
"800","707_2010_red","red",21,21,"707_2010",707,333.350371582031,"night",8336,679,6382,463,812,1491,6845,1142,7194,0.0814539347408829,0.765595009596929,0.055542226487524,0.0974088291746641,0.178862763915547,0.821137236084453,0.136996161228407,0.863003838771593,"2010"
"801","709_2013_red","red",21,21,"709_2013",709,285.532601367188,"night",7138,0,6537,0,601,601,6537,0,7138,0,0.91580274586719,0,0.0841972541328103,0.0841972541328103,0.91580274586719,0,1,"2013"
"802","709_2014_red","red",21,21,"709_2014",709,225.744583886719,"night",5634,71,4975,10,578,649,4985,81,5553,0.0126020589279375,0.883031593894214,0.0017749378771743,0.102591409300674,0.115193468228612,0.884806531771388,0.0143769968051118,0.985623003194888,"2014"
"803","710_2009_red","red",21,21,"710_2009",710,261.417959375,"night",6525,62,5566,768,129,191,6334,830,5695,0.00950191570881226,0.853026819923372,0.117701149425287,0.0197701149425287,0.029272030651341,0.970727969348659,0.1272030651341,0.8727969348659,"2009"
"804","710_2010_red","red",21,21,"710_2010",710,248.319120117188,"night",6204,410,4613,1063,118,528,5676,1473,4731,0.0660863958736299,0.743552546744036,0.17134107027724,0.0190199871050935,0.0851063829787234,0.914893617021277,0.23742746615087,0.76257253384913,"2010"
"805","710_2011_red","red",21,21,"710_2011",710,552.715821191406,"night",13809,268,11863,1397,281,549,13260,1665,12144,0.0194076327033094,0.859077413281193,0.101165906292997,0.0203490477224998,0.0397566804258093,0.960243319574191,0.120573538996307,0.879426461003693,"2011"
"806","711_2001_red","red",21,21,"711_2001",711,1665.11390478516,"night",41634,4684,31006,2577,3367,8051,33583,7261,34373,0.112504203295384,0.744727866647452,0.0618965268770716,0.0808714031800932,0.193375606475477,0.806624393524523,0.174400730172455,0.825599269827545,"2001"
"807","711_2010_red","red",21,21,"711_2010",711,710.680011523438,"night",17763,561,15513,821,868,1429,16334,1382,16381,0.0315825029555818,0.873332207397399,0.0462196701007713,0.0488656195462478,0.0804481225018296,0.91955187749817,0.0778021730563531,0.922197826943647,"2010"
"808","712_2014_red","red",21,21,"712_2014",712,708.949354394531,"night",17713,5381,10087,1578,667,6048,11665,6959,10754,0.303788178174222,0.569468751764241,0.089087111161294,0.0376559589002428,0.341444137074465,0.658555862925535,0.392875289335516,0.607124710664484,"2014"
"809","713_2005_red","red",21,21,"713_2005",713,1124.71105117187,"night",28122,6008,18703,2844,567,6575,21547,8852,19270,0.213640566104829,0.665066495981794,0.101130787283977,0.0201621506294005,0.233802716734229,0.766197283265771,0.314771353388806,0.685228646611194,"2005"
"810","714_2010_red","red",21,21,"714_2010",714,185.490418457031,"night",4635,344,3741,419,131,475,4160,763,3872,0.074217907227616,0.807119741100324,0.0903991370010788,0.0282632146709817,0.102481121898598,0.897518878101402,0.164617044228695,0.835382955771305,"2010"
"811","714_2011_red","red",21,21,"714_2011",714,160.960496484375,"night",4019,283,3281,334,121,404,3615,617,3402,0.070415526250311,0.816372231898482,0.0831052500622045,0.0301069917890022,0.100522518039313,0.899477481960687,0.153520776312516,0.846479223687484,"2011"
"812","716_2001_red","red",21,21,"716_2001",716,963.724555175781,"night",24097,1405,19893,1472,1327,2732,21365,2877,21220,0.0583060131966635,0.825538448769556,0.0610864422957215,0.0550690957380587,0.113375108934722,0.886624891065278,0.119392455492385,0.880607544507615,"2001"
"813","721_2010_red","red",21,21,"721_2010",721,462.890030859375,"night",11568,488,10014,316,750,1238,10330,804,10764,0.0421853388658368,0.865663900414938,0.0273167358229599,0.0648340248962656,0.107019363762102,0.892980636237898,0.0695020746887967,0.930497925311203,"2010"
"814","722_2003_red","red",21,21,"722_2003",722,81.13865625,"night",2028,72,177,1779,0,72,1956,1851,177,0.0355029585798817,0.0872781065088757,0.877218934911243,0,0.0355029585798817,0.964497041420118,0.912721893491124,0.0872781065088757,"2003"
"815","722_2004_red","red",21,21,"722_2004",722,188.046506835937,"night",4699,924,1091,2631,53,977,3722,3555,1144,0.196637582464354,0.232177058948712,0.559906363055969,0.011278995530964,0.207916577995318,0.792083422004682,0.756543945520323,0.243456054479677,"2004"
"816","734_2005_red","red",21,21,"734_2005",734,539.406859082031,"night",13481,3115,6994,2273,1099,4214,9267,5388,8093,0.231065944662859,0.518804243008679,0.16860767005415,0.081522142274312,0.312588086937171,0.687411913062829,0.399673614717009,0.600326385282991,"2005"
"817","113_2011_red","red",3,3,"113_2011",113,2999.48388730469,"day",74986,37649,24811,4608,7918,45567,29419,42257,32729,0.502080388339157,0.330875096684714,0.0614514709412424,0.105593044034887,0.607673432374043,0.392326567625957,0.563531859280399,0.436468140719601,"2011"
"818","117_2011_red","red",3,3,"117_2011",117,78.150962890625,"day",1956,1037,337,487,95,1132,824,1524,432,0.530163599182004,0.172290388548057,0.248977505112474,0.0485685071574642,0.578732106339468,0.421267893660532,0.779141104294479,0.220858895705521,"2011"
"819","119_2006_red","red",3,3,"119_2006",119,240.884041796875,"day",6021,544,4710,443,324,868,5153,987,5034,0.0903504401262249,0.782262082710513,0.0735758179704368,0.0538116591928251,0.14416209931905,0.85583790068095,0.163926258096662,0.836073741903338,"2006"
"820","120_2005_red","red",3,3,"120_2005",120,254.155295117188,"day",6352,2244,3437,421,250,2494,3858,2665,3687,0.353274559193955,0.541089420654912,0.0662783375314861,0.0393576826196474,0.392632241813602,0.607367758186398,0.419552896725441,0.580447103274559,"2005"
"821","120_2006_red","red",3,3,"120_2006",120,301.946503613281,"day",7544,2335,4448,452,309,2644,4900,2787,4757,0.309517497348887,0.589607635206787,0.059915164369035,0.0409597030752916,0.350477200424178,0.649522799575822,0.369432661717922,0.630567338282078,"2006"
"822","122_2011_red","red",3,3,"122_2011",122,229.472564941406,"day",5739,2758,2178,309,494,3252,2487,3067,2672,0.480571528140791,0.379508625196027,0.0538421327757449,0.0860777138874368,0.566649242028228,0.433350757971772,0.534413660916536,0.465586339083464,"2011"
"823","127_2008_red","red",3,3,"127_2008",127,466.237017382812,"day",11654,3316,4507,3373,458,3774,7880,6689,4965,0.284537497854814,0.386734168525828,0.289428522395744,0.0392998112236142,0.323837309078428,0.676162690921572,0.573966020250558,0.426033979749442,"2008"
"824","137_2010_red","red",3,3,"137_2010",137,312.798588183594,"day",7820,519,6409,448,444,963,6857,967,6853,0.0663682864450128,0.819565217391304,0.0572890025575448,0.0567774936061381,0.123145780051151,0.876854219948849,0.123657289002558,0.876342710997442,"2010"
"825","137_2011_red","red",3,3,"137_2011",137,284.607444824219,"day",7119,507,5816,395,401,908,6211,902,6217,0.0712178676780447,0.816968675375755,0.0554853209720466,0.0563281359741537,0.127546003652198,0.872453996347802,0.126703188650091,0.873296811349909,"2011"
"826","138_2010_red","red",3,3,"138_2010",138,605.471570117188,"day",15142,3963,9457,1087,635,4598,10544,5050,10092,0.261722361643112,0.624554220050192,0.0717870822876767,0.0419363360190199,0.303658697662132,0.696341302337868,0.333509443930789,0.666490556069211,"2010"
"827","287_2012_red","red",8,8,"287_2012",287,8266.90371337891,"day",206679,66128,102869,32946,4736,70864,135815,99074,107605,0.319955099453742,0.49772352295105,0.159406616056784,0.0229147615384243,0.342869860992167,0.657130139007833,0.479361715510526,0.520638284489474,"2012"
"830","289_2011_red","red",8,8,"289_2011",289,2311.66954707031,"day",57794,23046,23453,10609,686,23732,34062,33655,24139,0.398761117070976,0.405803370592103,0.18356576807281,0.0118697442641105,0.410630861335087,0.589369138664913,0.582326885143786,0.417673114856213,"2011"
"832","291_2011_red","red",8,8,"291_2011",291,640.788901074219,"day",16016,13339,0,2677,0,13339,2677,16016,0,0.832854645354645,0,0.167145354645355,0,0.832854645354645,0.167145354645355,1,0,"2011"
"837","295_2011_red","red",8,8,"295_2011",295,1651.29566962891,"day",41269,10157,27966,1708,1438,11595,29674,11865,29404,0.246116940076086,0.677651505973006,0.0413869975041799,0.0348445564467276,0.280961496522814,0.719038503477186,0.287503937580266,0.712496062419734,"2011"
"841","300_2011_red","red",8,8,"300_2011",300,1520.47228740234,"day",38006,5969,29696,966,1375,7344,30662,6935,31071,0.15705414934484,0.781350313108457,0.0254170394148292,0.0361784981318739,0.193232647476714,0.806767352523286,0.18247118875967,0.81752881124033,"2011"
"843","306_2011_red","red",8,8,"306_2011",306,112.776832324219,"day",2828,249,2214,85,280,529,2299,334,2494,0.088048090523338,0.782885431400283,0.0300565770862801,0.099009900990099,0.187057991513437,0.812942008486563,0.118104667609618,0.881895332390382,"2011"
"845","310_2011_red","red",8,8,"310_2011",310,1713.98248183594,"day",42843,21013,9321,12338,171,21184,21659,33351,9492,0.490465186844992,0.21756179539248,0.287981700627874,0.00399131713465444,0.494456503979647,0.505543496020353,0.778446887472866,0.221553112527134,"2011"
"849","313_2013_red","red",8,8,"313_2013",313,48.0306040039062,"day",1200,19,960,120,101,120,1080,139,1061,0.0158333333333333,0.8,0.1,0.0841666666666667,0.1,0.9,0.115833333333333,0.884166666666667,"2013"
"853","315_2011_red","red",8,8,"315_2011",315,379.457677832031,"day",9497,363,8238,259,637,1000,8497,622,8875,0.0382225966094556,0.867431820574918,0.0272717700326419,0.0670738127829841,0.10529640939244,0.89470359060756,0.0654943666420975,0.934505633357902,"2011"
"854","344_2013_red","red",8,8,"344_2013",344,105.901614746094,"day",2645,55,2289,9,292,347,2298,64,2581,0.0207939508506616,0.865406427221172,0.00340264650283554,0.110396975425331,0.131190926275992,0.868809073724008,0.0241965973534972,0.975803402646503,"2013"
"855","345_2011_red","red",8,8,"345_2011",345,463.354283886719,"day",11579,2656,7244,1066,613,3269,8310,3722,7857,0.229380775541929,0.625615338112099,0.0920632178944641,0.052940668451507,0.282321443993436,0.717678556006564,0.321443993436393,0.678556006563606,"2011"
"857","348_2011_red","red",8,8,"348_2011",348,1543.44880585937,"day",38589,7419,26185,2502,2483,9902,28687,9921,28668,0.19225686076343,0.678561248024048,0.0648371297520019,0.0643447614605198,0.25660162222395,0.74339837777605,0.257093990515432,0.742906009484568,"2011"
"859","351_2011_red","red",8,8,"351_2011",351,286.831761816406,"day",7177,240,5988,91,858,1098,6079,331,6846,0.0334401560540616,0.834331893548837,0.0126793925038317,0.11954855789327,0.152988713947332,0.847011286052668,0.0461195485578933,0.953880451442107,"2011"
"865","365_2011_red","red",8,8,"365_2011",365,1088.89218691406,"day",27219,3507,19835,3385,492,3999,23220,6892,20327,0.12884382232999,0.728718909585216,0.124361659135163,0.0180756089496308,0.146919431279621,0.853080568720379,0.253205481465153,0.746794518534847,"2011"
"872","371_2011_red","red",8,8,"371_2011",371,1671.00780390625,"day",41772,20319,8640,12707,106,20425,21347,33026,8746,0.486426314277506,0.20683711577133,0.304198984966006,0.00253758498515752,0.488963899262664,0.511036100737336,0.790625299243512,0.209374700756488,"2011"
"876","376_2011_red","red",8,8,"376_2011",376,4411.65770888672,"day",110295,46475,39447,22900,1473,47948,62347,69375,40920,0.421369962373634,0.35764993880049,0.207625005666621,0.0133550931592547,0.434725055532889,0.565274944467111,0.628994968040256,0.371005031959744,"2011"
"877","376_2012_red","red",8,8,"376_2012",376,4464.89824189453,"day",111624,44414,44049,21398,1763,46177,65447,65812,45812,0.397889342793664,0.394619436680284,0.191697126066079,0.0157940944599728,0.413683437253637,0.586316562746363,0.589586468859743,0.410413531140257,"2012"
"884","387_2013_red","red",8,8,"387_2013",387,553.969425292969,"day",13854,2284,9946,910,714,2998,10856,3194,10660,0.164862133679804,0.717915403493576,0.0656850007218132,0.0515374621048073,0.216399595784611,0.783600404215389,0.230547134401617,0.769452865598383,"2013"
"885","389_2013_red","red",8,8,"389_2013",389,1620.80649707031,"day",40522,9888,27382,1767,1485,11373,29149,11655,28867,0.244015596466117,0.67573170129806,0.0436059424510143,0.0366467597848083,0.280662356250925,0.719337643749075,0.287621538917131,0.712378461082869,"2013"
"886","390_2013_red","red",8,8,"390_2013",390,1120.16337871094,"day",28001,3285,23124,661,931,4216,23785,3946,24055,0.117317238670047,0.825827649012535,0.023606299775008,0.0332488125424092,0.150566051212457,0.849433948787543,0.140923538445056,0.859076461554944,"2013"
"887","391_2013_red","red",8,8,"391_2013",391,433.037766894531,"day",10825,2003,7233,831,758,2761,8064,2834,7991,0.185034642032333,0.668175519630485,0.0767667436489607,0.0700230946882217,0.255057736720554,0.744942263279446,0.261801385681293,0.738198614318707,"2013"
"888","392_2013_red","red",8,8,"392_2013",392,325.194807910156,"day",8135,1158,5601,626,750,1908,6227,1784,6351,0.142347879532883,0.688506453595575,0.0769514443761524,0.0921942224953903,0.234542102028273,0.765457897971727,0.219299323909035,0.780700676090965,"2013"
"889","393_2013_red","red",8,8,"393_2013",393,2200.15728486328,"day",55005,29264,10968,14165,608,29872,25133,43429,11576,0.532024361421689,0.199400054540496,0.257522043450595,0.0110535405872193,0.543077902008908,0.456922097991092,0.789546404872284,0.210453595127716,"2013"
"890","394_2013_red","red",8,8,"394_2013",394,1200.05876757813,"day",30002,3201,23452,1778,1571,4772,25230,4979,25023,0.106692887140857,0.781681221251917,0.0592627158189454,0.0523631757882808,0.159056062929138,0.840943937070862,0.165955602959803,0.834044397040197,"2013"
"891","395_2013_red","red",8,8,"395_2013",395,1879.43264179688,"day",46997,21842,14044,10485,626,22468,24529,32327,14670,0.464753069344852,0.298827584739451,0.223099346766815,0.0133199991488818,0.478073068493734,0.521926931506266,0.687852416111667,0.312147583888333,"2013"
"892","396_2013_red","red",8,8,"396_2013",396,330.242189648437,"day",8269,396,6566,786,521,917,7352,1182,7087,0.047889708550006,0.794050066513484,0.095053815455315,0.0630064094811948,0.110896118031201,0.889103881968799,0.142943524005321,0.857056475994679,"2013"
"893","397_2013_red","red",8,8,"397_2013",397,150.298359179688,"day",3765,102,3128,322,213,315,3450,424,3341,0.0270916334661355,0.830810092961487,0.0855245683930943,0.0565737051792829,0.0836653386454183,0.916334661354582,0.11261620185923,0.88738379814077,"2013"
"894","398_2013_red","red",8,8,"398_2013",398,56.5333525390625,"day",1413,294,746,298,75,369,1044,592,821,0.208067940552017,0.527954706298655,0.210898796886058,0.0530785562632696,0.261146496815287,0.738853503184713,0.418966737438075,0.581033262561925,"2013"
"895","399_2013_red","red",8,8,"399_2013",399,136.497841308594,"day",3417,1175,1503,519,220,1395,2022,1694,1723,0.343868890839918,0.439859525899912,0.15188762071993,0.06438396254024,0.408252853380158,0.591747146619842,0.495756511559848,0.504243488440152,"2013"
"896","444_2010_red","red",14,14,"444_2010",444,1074.14888300781,"day",26859,1976,24482,142,259,2235,24624,2118,24741,0.0735693808406866,0.911500800476563,0.00528686846122343,0.00964295022152723,0.0832123310622138,0.916787668937786,0.07885624930191,0.92114375069809,"2010"
"897","445_2009_red","red",14,14,"445_2009",445,3478.58695019531,"day",86959,19030,61665,4905,1359,20389,66570,23935,63024,0.218838763095252,0.709127289872239,0.0564058924320657,0.0156280546004439,0.234466817695696,0.765533182304304,0.275244655527317,0.724755344472683,"2009"
"898","445_2010_red","red",14,14,"445_2010",445,3010.8400859375,"day",75272,11171,59840,3362,899,12070,63202,14533,60739,0.148408438728877,0.794983526410883,0.044664682750558,0.0119433521096822,0.160351790838559,0.839648209161441,0.193073121479435,0.806926878520565,"2010"
"899","446_2009_red","red",14,14,"446_2009",446,1516.97247041016,"day",37918,1693,35543,306,376,2069,35849,1999,35919,0.0446489793765494,0.937364839917717,0.00807004588849623,0.0099161348172372,0.0545651141937866,0.945434885806213,0.0527190252650456,0.947280974734954,"2009"
"900","446_2010_red","red",14,14,"446_2010",446,485.430795214844,"day",12128,390,11581,51,106,496,11632,441,11687,0.0321569920844327,0.954897757255937,0.00420514511873351,0.0087401055408971,0.0408970976253298,0.95910290237467,0.0363621372031662,0.963637862796834,"2010"
"901","447_2013_red","red",14,14,"447_2013",447,2969.83917792969,"day",74243,22652,46862,3040,1689,24341,49902,25692,48551,0.305106205298816,0.631197553978153,0.0409466212302843,0.0227496194927468,0.327855824791563,0.672144175208437,0.3460528265291,0.6539471734709,"2013"
"902","448_2010_red","red",14,14,"448_2010",448,451.544725,"day",11289,51,11161,4,73,124,11165,55,11234,0.00451767207015679,0.988661528921959,0.000354327221188768,0.00646647178669501,0.0109841438568518,0.989015856143148,0.00487199929134556,0.995128000708654,"2010"
"903","448_2011_red","red",14,14,"448_2011",448,390.41198828125,"day",9744,0,9658,5,81,81,9663,5,9739,0,0.991174055829228,0.000513136288998358,0.0083128078817734,0.0083128078817734,0.991687192118227,0.000513136288998358,0.999486863711002,"2011"
"904","449_2009_red","red",14,14,"449_2009",449,838.389096582031,"day",20966,13543,5391,1715,317,13860,7106,15258,5708,0.645950586664123,0.257130592387675,0.0817991033101211,0.0151197176380807,0.661070304302204,0.338929695697796,0.727749689974244,0.272250310025756,"2009"
"905","449_2010_red","red",14,14,"449_2010",449,916.556219042969,"day",22914,13061,8011,1562,280,13341,9573,14623,8291,0.570000872828838,0.349611591166972,0.0681679322684822,0.0122196037357074,0.582220476564546,0.417779523435454,0.63816880509732,0.36183119490268,"2010"
"906","451_2010_red","red",14,14,"451_2010",451,393.718894921875,"day",9843,1630,7627,452,134,1764,8079,2082,7761,0.165599918723966,0.774865386569135,0.045920959057198,0.0136137356497003,0.179213654373667,0.820786345626333,0.211520877781164,0.788479122218836,"2010"
"907","451_2011_red","red",14,14,"451_2011",451,317.773238476562,"day",7941,997,6561,250,133,1130,6811,1247,6694,0.125550938168996,0.826218360408009,0.0314821810855056,0.016748520337489,0.142299458506485,0.857700541493515,0.157033119254502,0.842966880745498,"2011"
"908","452_2010_red","red",14,14,"452_2010",452,1404.68563935547,"day",35103,19506,14407,414,776,20282,14821,19920,15183,0.555679001794718,0.410420761758254,0.0117938637723272,0.0221063726747002,0.577785374469419,0.422214625530581,0.567472865567046,0.432527134432954,"2010"
"909","456_2009_red","red",14,14,"456_2009",456,1295.77381953125,"day",32399,5247,25057,630,1465,6712,25687,5877,26522,0.16194944288404,0.773388067532949,0.019445044600142,0.0452174449828698,0.207166887866909,0.79283311213309,0.181394487484182,0.818605512515818,"2009"
"910","458_2008_red","red",14,14,"458_2008",458,136.783845117187,"day",3422,2956,0,466,0,2956,466,3422,0,0.863822326125073,0,0.136177673874927,0,0.863822326125073,0.136177673874927,1,0,"2008"
"911","458_2009_red","red",14,14,"458_2009",458,564.849914160156,"day",14115,10134,2350,1384,247,10381,3734,11518,2597,0.717959617428268,0.166489550123982,0.098051718030464,0.0174991144172866,0.735458731845554,0.264541268154446,0.816011335458732,0.183988664541268,"2009"
"912","458_2010_red","red",14,14,"458_2010",458,127.684022753906,"day",3191,2355,41,778,17,2372,819,3133,58,0.738013162018176,0.0128486367909746,0.243810717643372,0.00532748354747728,0.743340645565653,0.256659354434347,0.981823879661548,0.0181761203384519,"2010"
"913","458_2011_red","red",14,14,"458_2011",458,70.8864610351562,"day",1766,1391,0,375,0,1391,375,1766,0,0.787655719139298,0,0.212344280860702,0,0.787655719139298,0.212344280860702,1,0,"2011"
"914","459_2010_red","red",14,14,"459_2010",459,803.043645800781,"day",20079,5852,10927,2370,930,6782,13297,8222,11857,0.291448777329548,0.544200408386872,0.118033766621844,0.0463170476617361,0.337765824991284,0.662234175008716,0.409482543951392,0.590517456048608,"2010"
"915","459_2011_red","red",14,14,"459_2011",459,655.827899414062,"day",16388,3352,11252,948,836,4188,12200,4300,12088,0.204539907249207,0.686599951183793,0.0578472052721504,0.0510129362948499,0.255552843544057,0.744447156455943,0.262387112521357,0.737612887478643,"2011"
"916","459_2012_red","red",14,14,"459_2012",459,1051.38663164062,"day",26279,7298,15137,2595,1249,8547,17732,9893,16386,0.277712241713916,0.576011263746718,0.0987480497735835,0.0475284447657826,0.325240686479699,0.674759313520301,0.3764602914875,0.623539708512501,"2012"
"917","460_2010_red","red",14,14,"460_2010",460,5965.72164042969,"day",149137,115371,12063,21510,193,115564,33573,136881,12256,0.773590725306262,0.0808853604404004,0.144229802128244,0.00129411212509304,0.774884837431355,0.225115162568645,0.917820527434506,0.0821794725654935,"2010"
"918","460_2011_red","red",14,14,"460_2011",460,7736.60586435547,"day",193399,150686,18457,23824,432,151118,42281,174510,18889,0.779145703959172,0.0954348264468793,0.123185745531259,0.00223372406268905,0.781379428021862,0.218620571978138,0.902331449490432,0.0976685505095683,"2011"
"919","461_2010_red","red",14,14,"461_2010",461,865.181651171875,"day",21617,12663,7783,292,879,13542,8075,12955,8662,0.585788962390711,0.360040708701485,0.0135078873109127,0.0406624415968913,0.626451403987602,0.373548596012398,0.599296849701624,0.400703150298376,"2010"
"920","461_2011_red","red",14,14,"461_2011",461,600.361327441406,"day",15004,6438,7786,220,560,6998,8006,6658,8346,0.429085577179419,0.518928285790456,0.0146627565982405,0.0373233804318848,0.466408957611304,0.533591042388696,0.443748333777659,0.556251666222341,"2011"
"921","462_2010_red","red",14,14,"462_2010",462,1049.47901103516,"day",26231,13982,10926,320,1003,14985,11246,14302,11929,0.533033433723457,0.416530059852846,0.0121993061644619,0.0382372002592353,0.571270633982692,0.428729366017308,0.545232739887919,0.454767260112081,"2010"
"922","463_2010_red","red",14,14,"463_2010",463,3664.64142109375,"day",91610,46866,34661,8558,1525,48391,43219,55424,36186,0.511581705054033,0.378353891496562,0.0934177491540225,0.0166466542953826,0.528228359349416,0.471771640650584,0.604999454208056,0.395000545791944,"2010"
"923","465_2010_red","red",14,14,"465_2010",465,4124.97468496094,"day",103123,56079,37635,7484,1925,58004,45119,63563,39560,0.543806910194622,0.36495253241275,0.0725735286987384,0.0186670286938898,0.562473938888512,0.437526061111488,0.61638043889336,0.38361956110664,"2010"
"924","466_2013_red","red",14,14,"466_2013",466,787.125453515625,"day",19686,6042,12323,611,710,6752,12934,6653,13033,0.306918622371228,0.625977852280809,0.0310372853804734,0.0360662399674896,0.342984862338718,0.657015137661282,0.337955907751702,0.662044092248298,"2013"
"925","724_2013_red","red",17,17,"724_2013",724,264.421883789063,"day",6609,422,5868,184,135,557,6052,606,6003,0.063852322590407,0.887880163413527,0.0278408231199879,0.0204266908760781,0.0842790134664851,0.915720986533515,0.0916931457103949,0.908306854289605,"2013"
"926","724_2014_red","red",17,17,"724_2014",724,170.263096777344,"day",4252,124,3967,65,96,220,4032,189,4063,0.0291627469426152,0.932972718720602,0.0152869238005644,0.0225776105362183,0.0517403574788335,0.948259642521166,0.0444496707431797,0.95555032925682,"2014"
"927","725_2009_red","red",17,17,"725_2009",725,265.910726953125,"day",6655,1068,4301,572,714,1782,4873,1640,5015,0.160480841472577,0.646280991735537,0.0859504132231405,0.107287753568745,0.267768595041322,0.732231404958678,0.246431254695717,0.753568745304283,"2009"
"928","725_2010_red","red",17,17,"725_2010",725,233.791365527344,"day",5842,1114,3568,555,605,1719,4123,1669,4173,0.190688120506676,0.610749743238617,0.0950017117425539,0.103560424512153,0.294248545018829,0.705751454981171,0.28568983224923,0.71431016775077,"2010"
"929","727_2002_red","red",17,17,"727_2002",727,255.609970214844,"day",6398,1028,4433,497,440,1468,4930,1525,4873,0.160675211003439,0.692872772741482,0.0776805251641138,0.0687714910909659,0.229446702094405,0.770553297905595,0.238355736167552,0.761644263832448,"2002"
"930","730_2013_red","red",17,17,"730_2013",730,1435.48329462891,"day",35885,3895,27055,3751,1184,5079,30806,7646,28239,0.108541173192142,0.75393618503553,0.104528354465654,0.0329942873066741,0.141535460498816,0.858464539501184,0.213069527657796,0.786930472342204,"2013"
"931","742_2009_red","red",17,17,"742_2009",742,372.23986328125,"day",9306,1775,5796,913,822,2597,6709,2688,6618,0.190737158822265,0.622823984526112,0.0981087470449173,0.0883301096067054,0.279067268428971,0.720932731571029,0.288845905867182,0.711154094132817,"2009"
"932","742_2010_red","red",17,17,"742_2010",742,1296.57136464844,"day",32421,12302,16373,1637,2109,14411,18010,13939,18482,0.379445421177632,0.505012183461337,0.0504919650843589,0.0650504302766725,0.444495851454304,0.555504148545696,0.429937386261991,0.570062613738009,"2010"
"933","743_2004_red","red",17,17,"743_2004",743,292.64650859375,"day",7320,917,5363,579,461,1378,5942,1496,5824,0.125273224043716,0.732650273224044,0.0790983606557377,0.0629781420765027,0.188251366120219,0.811748633879781,0.204371584699454,0.795628415300546,"2004"
"934","744_2009_red","red",17,17,"744_2009",744,129.102432128906,"day",3230,0,2584,17,629,629,2601,17,3213,0,0.8,0.00526315789473684,0.194736842105263,0.194736842105263,0.805263157894737,0.00526315789473684,0.994736842105263,"2009"
"935","744_2010_red","red",17,17,"744_2010",744,586.436230371094,"day",14662,1037,11089,939,1597,2634,12028,1976,12686,0.070727049515755,0.756308825535398,0.0640431046241986,0.108921020324649,0.179648069840404,0.820351930159596,0.134770154139954,0.865229845860046,"2010"
"936","745_2010_red","red",17,17,"745_2010",745,832.928866992188,"day",20828,1296,18359,490,683,1979,18849,1786,19042,0.0622239293259074,0.881457653159209,0.0235260226618014,0.0327923948530824,0.0950163241789898,0.90498367582101,0.0857499519877089,0.914250048012291,"2010"
"937","747_2002_red","red",17,17,"747_2002",747,287.739345703125,"day",7207,1,6752,47,407,408,6799,48,7159,0.000138753989177189,0.936866934924379,0.00652143749132788,0.0564728735951159,0.056611627584293,0.943388372415707,0.00666019148050506,0.993339808519495,"2002"
"938","748_2005_red","red",17,17,"748_2005",748,4271.43849628906,"day",106781,9918,83520,7235,6108,16026,90755,17153,89628,0.0928816924359202,0.782161620513013,0.0677554995738942,0.0572011874771729,0.150082879913093,0.849917120086907,0.160637192009814,0.839362807990185,"2005"
"939","752_2002_red","red",17,17,"752_2002",752,159.151158007813,"day",3982,1100,2497,170,215,1315,2667,1270,2712,0.276243093922652,0.62707182320442,0.0426921145153189,0.0539929683576092,0.330236062280261,0.669763937719739,0.318935208437971,0.681064791562029,"2002"
"940","754_2010_red","red",17,17,"754_2010",754,145.979270214844,"day",3642,382,2469,359,432,814,2828,741,2901,0.104887424492037,0.677924217462932,0.0985722130697419,0.118616144975288,0.223503569467326,0.776496430532674,0.203459637561779,0.796540362438221,"2010"
"941","757_2012_red","red",17,17,"757_2012",757,197.528928417969,"day",4940,49,4317,94,480,529,4411,143,4797,0.00991902834008097,0.873886639676113,0.0190283400809717,0.097165991902834,0.107085020242915,0.892914979757085,0.0289473684210526,0.971052631578947,"2012"
"942","757_2013_red","red",17,17,"757_2013",757,199.556068457031,"day",4986,0,4569,0,417,417,4569,0,4986,0,0.916365824308063,0,0.0836341756919374,0.0836341756919374,0.916365824308063,0,1,"2013"
"943","758_2009_red","red",17,17,"758_2009",758,370.147850097656,"day",9245,1368,6334,632,911,2279,6966,2000,7245,0.147971876690103,0.68512709572742,0.068361276365603,0.098539751216874,0.246511627906977,0.753488372093023,0.216333153055706,0.783666846944294,"2009"
"944","758_2010_red","red",17,17,"758_2010",758,206.456110253906,"day",5155,1018,3436,259,442,1460,3695,1277,3878,0.197478176527643,0.666537342386033,0.0502424830261882,0.0857419980601358,0.283220174587779,0.716779825412221,0.247720659553831,0.752279340446169,"2010"
"945","759_2014_red","red",17,17,"759_2014",759,118.632830273438,"day",2967,647,1695,447,178,825,2142,1094,1873,0.218065385911695,0.571284125379171,0.150657229524773,0.0599932591843613,0.278058645096057,0.721941354903943,0.368722615436468,0.631277384563532,"2014"
"946","760_2009_red","red",17,17,"760_2009",760,251.152916601563,"day",6275,953,4500,250,572,1525,4750,1203,5072,0.151872509960159,0.717131474103586,0.0398406374501992,0.0911553784860558,0.243027888446215,0.756972111553785,0.191713147410359,0.808286852589641,"2009"
"947","760_2010_red","red",17,17,"760_2010",760,289.180404492188,"day",7233,1056,5192,268,717,1773,5460,1324,5909,0.145997511406056,0.71782109774644,0.037052398728052,0.0991289921194525,0.245126503525508,0.754873496474492,0.183049910134108,0.816950089865892,"2010"
"948","762_2009_red","red",17,17,"762_2009",762,167.186818847656,"day",4185,406,3117,116,546,952,3233,522,3663,0.0970131421744325,0.744802867383513,0.0277180406212664,0.130465949820789,0.227479091995221,0.772520908004779,0.124731182795699,0.875268817204301,"2009"
"949","762_2010_red","red",17,17,"762_2010",762,193.347434960938,"day",4841,101,3888,86,766,867,3974,187,4654,0.0208634579632307,0.803139847139021,0.0177649246023549,0.158231770295394,0.179095228258624,0.820904771741376,0.0386283825655856,0.961371617434414,"2010"
"950","763_2014_red","red",17,17,"763_2014",763,520.215326757812,"day",13006,390,11783,264,569,959,12047,654,12352,0.0299861602337383,0.905966477010611,0.0202983238505305,0.0437490389051207,0.073735199138859,0.926264800861141,0.0502844840842688,0.949715515915731,"2014"
"951","702_2005_red","red",21,21,"702_2005",702,50.0472866210937,"day",1255,20,647,548,40,60,1195,568,687,0.0159362549800797,0.515537848605578,0.436653386454183,0.0318725099601594,0.047808764940239,0.952191235059761,0.452589641434263,0.547410358565737,"2005"
"952","702_2006_red","red",21,21,"702_2006",702,131.577222949219,"day",3290,25,2371,830,64,89,3201,855,2435,0.00759878419452888,0.720668693009119,0.252279635258359,0.0194528875379939,0.0270516717325228,0.972948328267477,0.259878419452888,0.740121580547112,"2006"
"953","703_2009_red","red",21,21,"703_2009",703,134.91145859375,"day",3370,0,3280,52,38,38,3332,52,3318,0,0.973293768545994,0.0154302670623145,0.0112759643916914,0.0112759643916914,0.988724035608309,0.0154302670623145,0.984569732937685,"2009"
"954","703_2010_red","red",21,21,"703_2010",703,172.998048046875,"day",4326,0,4161,97,68,68,4258,97,4229,0,0.961858529819695,0.0224225612575127,0.0157189089227924,0.0157189089227924,0.984281091077208,0.0224225612575127,0.977577438742487,"2010"
"955","706_2010_red","red",21,21,"706_2010",706,159.500940234375,"day",3988,225,3611,88,64,289,3699,313,3675,0.05641925777332,0.905466399197593,0.0220661985957874,0.0160481444332999,0.0724674022066199,0.92753259779338,0.0784854563691073,0.921514543630893,"2010"
"956","706_2011_red","red",21,21,"706_2011",706,191.904232714844,"day",4795,161,4483,78,73,234,4561,239,4556,0.0335766423357664,0.934932221063608,0.016266944734098,0.0152241918665276,0.0488008342022941,0.951199165797706,0.0498435870698644,0.950156412930136,"2011"
"957","707_2010_red","red",21,21,"707_2010",707,308.239372070313,"day",7703,361,6214,288,840,1201,6502,649,7054,0.0468648578475918,0.806698688822537,0.037388030637414,0.109048422692457,0.155913280540049,0.844086719459951,0.0842528884850058,0.915747111514994,"2010"
"958","709_2013_red","red",21,21,"709_2013",709,215.8997515625,"day",5397,0,4719,194,484,484,4913,194,5203,0,0.874374652584769,0.0359458958680749,0.0896794515471558,0.0896794515471558,0.910320548452844,0.0359458958680749,0.964054104131925,"2013"
"959","709_2014_red","red",21,21,"709_2014",709,185.031489257812,"day",4619,0,4033,189,397,397,4222,189,4430,0,0.873132712708378,0.0409179476077073,0.0859493396839143,0.0859493396839143,0.914050660316086,0.0409179476077073,0.959082052392293,"2014"
"960","710_2009_red","red",21,21,"710_2009",710,179.37586328125,"day",4491,53,3383,954,101,154,4337,1007,3484,0.0118013805388555,0.753284346470719,0.212424849699399,0.0224894232910265,0.034290803829882,0.965709196170118,0.224226230238254,0.775773769761746,"2009"
"961","710_2010_red","red",21,21,"710_2010",710,133.082970703125,"day",3330,49,2595,634,52,101,3229,683,2647,0.0147147147147147,0.779279279279279,0.19039039039039,0.0156156156156156,0.0303303303303303,0.96966966966967,0.205105105105105,0.794894894894895,"2010"
"962","710_2011_red","red",21,21,"710_2011",710,320.060366796875,"day",7995,54,6293,1460,188,242,7753,1514,6481,0.00675422138836773,0.787116948092558,0.182614133833646,0.0235146966854284,0.0302689180737961,0.969731081926204,0.189368355222014,0.810631644777986,"2011"
"963","711_2001_red","red",21,21,"711_2001",711,1255.04602089844,"day",31381,957,26396,1973,2055,3012,28369,2930,28451,0.0304961600968739,0.841145916318792,0.0628724387368153,0.0654854848475192,0.0959816449443931,0.904018355055607,0.0933685988336892,0.906631401166311,"2001"
"964","711_2010_red","red",21,21,"711_2010",711,266.471124121094,"day",6661,0,5676,387,598,598,6063,387,6274,0,0.852124305659811,0.0580993844768053,0.0897763098633839,0.0897763098633839,0.910223690136616,0.0580993844768053,0.941900615523195,"2010"
"965","712_2014_red","red",21,21,"712_2014",712,497.887868652344,"day",12449,1029,10170,746,504,1533,10916,1775,10674,0.0826572415455057,0.816933086994939,0.0599244919270624,0.0404851795324926,0.123142421077998,0.876857578922002,0.142581733472568,0.857418266527432,"2014"
"966","713_2005_red","red",21,21,"713_2005",713,372.385089648437,"day",9302,75,7528,1416,283,358,8944,1491,7811,0.00806278219737691,0.809288325091378,0.152225327886476,0.0304235648247689,0.0384863470221458,0.961513652977854,0.160288110083853,0.839711889916147,"2005"
"967","714_2010_red","red",21,21,"714_2010",714,85.5882849609375,"day",2143,0,2141,0,2,2,2141,0,2143,0,0.999066728884741,0,0.000933271115258983,0.000933271115258983,0.999066728884741,0,1,"2010"
"968","714_2011_red","red",21,21,"714_2011",714,43.151654296875,"day",1079,0,1078,0,1,1,1078,0,1079,0,0.999073215940686,0,0.00092678405931418,0.00092678405931418,0.999073215940686,0,1,"2011"
"969","716_2001_red","red",21,21,"716_2001",716,881.426680566406,"day",22034,974,18694,1089,1277,2251,19783,2063,19971,0.0442044113642552,0.848416084233457,0.0494236180448398,0.0579558863574476,0.102160297721703,0.897839702278297,0.093628029409095,0.906371970590905,"2001"
"970","721_2010_red","red",21,21,"721_2010",721,217.350423144531,"day",5434,0,4872,0,562,562,4872,0,5434,0,0.896577107103423,0,0.103422892896577,0.103422892896577,0.896577107103423,0,1,"2010"
"971","722_2003_red","red",21,21,"722_2003",722,43.4469633789062,"day",1078,0,5,1073,0,0,1078,1073,5,0,0.00463821892393321,0.995361781076067,0,0,1,0.995361781076067,0.00463821892393321,"2003"
"972","722_2004_red","red",21,21,"722_2004",722,168.727709277344,"day",4227,588,906,2704,29,617,3610,3292,935,0.139105748757984,0.214336408800568,0.639697184764608,0.00686065767683937,0.145966406434824,0.854033593565176,0.778802933522593,0.221197066477407,"2004"
"973","734_2005_red","red",21,21,"734_2005",734,733.542023828125,"day",18346,5847,8378,2736,1385,7232,11114,8583,9763,0.318707075111741,0.456666303281369,0.149133326065627,0.0754932955412624,0.394200370653003,0.605799629346997,0.467840401177368,0.532159598822632,"2005"
